آی	/ɒːj/
یا	/jɒː/
ایالات متحده	/ejɒːlɒːte mottæhede/
ایالات متحدۀ آمریکا	/ejɒːlɒːte mottæhedeje ɒːmɾiːkɒː/
آب	/ɒːb/
آبی	/ɒːbiː/
ابا	/æbɒː/
ابابیل	/æbɒːbiːl/
اباختر	/æbɒːxtæɾ/
آبادی	/ɒːbɒːdiː/
آبادان	/ɒːbædæn/
آباژور	/ɒːbɒːʒuːɾ/
آبی آسمانی	/ɒːbiːje ɒːsemɒːniː/
آب اکسیژنه	/ɒːb oksiːʒene/
آبان	/ɒːbɒːn/
آب‌پنیر	/ɒːbpæniːɾ/
آبتنی	/ɒːbtæniː/
آبتنی کردن	/ɒːbtæniːkæɾdæn/
ابجد	/ɒːbǧæd/
آبجو	/ɒːbd͡ʒo/
آبجو	/ɒːbd͡ʒoʊ/
آبجو زدن	/ɒːbd͡ʒozædæn/
آبچین	/ɒːbt͡ʃiːn/
آب حیات	/ɒːbe hejɒːt/
آبخاز	/ɒːbxɒːz/
آبخازستان	/ɒːbxɒːzestɒːn/
آبخازیه	/ɒːbxɒːziːje/
آب دادن	/ɒːbdɒːdæn/
آبدست	/ɒːbdæst/
ابر	/æbæɾ/
آبراه	/ɒːbɾɒːh/
ابراهیم	/ebɾɒːhiːm/, /iːbɾɒːhiːm/
ابر اورت	/æbɾe uːɾt/
ابربازار	/æbɾæbɒːzɒːɾ/
آبریز	/ɒːbɾiːz/
ابریشم	/æbɾiːʃæm/
ابریق	/ebɾiːɢ/
ابرنواختر	/æbæɾnouːæxtæɾ/
ابرو	/æbɾuː/
آبزیدان	/ɒːbziːdɒːn/
آب زدن	/ɒːbzædæn/
آبزی شناسی	/ɒːbziː ʃenɒːsiː/
آب سیب	/ɒːbe siːb/
آبستنی	/ɒːbestæniː/
آب‌سنگ	/ɒːbsænɡ/
آبشار	/ɒːbʃɒːɾ/
آبشار	/ɒːbʃɒːɾʔ/
آب شدن	/ɒːbʃodæn/
آبغوره	/ɒːbɢuːɾe/
آبغوره گرفتن	/ɒːbɢuːɾeɡeɾeftæn/
آبفشاری	/ɒːbfeʃæɾiː/
آب کردن	/ɒːbkæɾdæn/
آبکش	/ɒːbkeʃ/
آب کشیدن	/ɒːbkeʃiːdæn/
آبکش کردن	/ɒːbkeʃkæɾdæn/
آب گرفتن	/ɒːbɡeɾeftæn/
آبگینه	/ɒːbɡiːne/
آبگونه	/ɒːbɡuːne/
ابلاغ	/eblɒːɢ/
ابلاغ کردن	/eblɒːɢkæɾdæn/
آبْلرْزه	/ɒːblæɾze/
آب معدنی	/ɒːb mæʔdæniː/
آبمیوه	/ɒːbmiːve/
ابن سینا	/ebne siːnɒː/
آب‌نما	/ɒːbnæmɒː/
ابهام	/ebhɒːm/
ابوالهول	/æbuːælhuːl/
ابوظبی	/æbuːzɒːbiː/
آب و هوا	/ɒːbohævɒː/
اپاختر	/æpɒːxtæɾ/
آی‌پاد	/ɒːjpɒːd/
آپارتمان	/ɒːpɒːɾtemɒːn/
اپسیلون	/epsiːlon/
اپی فیلوم	/epiː fiːluːm/
اپل	/epl/
اتازونی	/etɒːzuːniː/
اتاق	/otɒːɢ/
اتاق گاز	/otɒːɢe ɡɒːz/
ایتالیایی	/iːtæliːjɒːjiː/
ایتالیا	/iːtɒːliːjɒː/
آیت‌الله	/ɒːjætollɒːh/
اتحاد	/ettehɒːd/
اتحاد جماهیر شوروی سوسیالیستی	/ettehɒːde d͡ʒæmɒːhiːɾe ʃuːɾæviːje sosiːjɒːliːstiː/
اتحاد شوروی	/ettehɒːde ʃouːɾæviː/
اتحاد شوروی	/ettehɒːde ʃuːɾæviː/
اتحادیه اروپا	/ettehɒːdiːje oɾuːpɒː/
اتحادیه آفریقا	/ettehɒːdiːje ɒːfɾiːɢɒː/
اتریش	/otɾiːʃ/
آتش	/ɒːtæʃ/
آتش‌بس	/ɒːtæʃbæs/
آتش زدن	/ɒːtæʃzædæn/
آتشسوزی	/ɒːtæʃsuːziː/
آتش‌فشان	/ɒːteʃfeʃɒːn/
آتش کشیدن	/ɒːtæʃkeʃiːdæn/
آتش گرفتن	/ɒːtæʃɡeɾeftæn/
آتش‌نشان	/ɒːtæʃneʃɒːn/
اتصال	/ettesɒːl/
اتصال مجازی	/ettesɒːle mæd͡ʒɒːziː/
اتفاقا	/ettefɒːɢæn/
اتفاقه دیگه	/ettefɒːɢe diːɡe/
آتن	/ɒːten/
آتنا	/ɒːtenɒː/
اتهام	/ettehɒːm/
اتهام خوردن	/ettehɒːmxoɾdæn/
اتهام زدن	/ettehɒːmzædæn/
اتو	/otuː/
اتوبوس	/otobuːs/
اتود	/etuːd/
اتود زدن	/etuːdzædæn/
اتو زدن	/otuːzædæn/
اتو کردن	/otuːkæɾdæn/
اثر	/æsæɾ/
اثر کردن	/æsæɾkæɾdæn/
اثر گرفتن	/æsæɾɡeɾeftæn/
ایجاد	/iːd͡ʒɒːd/
ایجاد شدن	/iːd͡ʒɒːdʃodæn/
ایجاد کردن	/iːd͡ʒɒːdkæɾdæn/
اجاره	/ed͡ʒɒːɾe/
اجاره دادن	/ed͡ʒɒːɾe dɒːdæn/
اجاره دادن	/ed͡ʒɒːɾedɒːdæn/
اجاره کردن	/ed͡ʒɒːɾe kæɾdæn/
اجاره کردن	/ed͡ʒɒːɾekæɾdæn/
اجازه	/ed͡ʒɒːze/
اجازه دادن	/ed͡ʒɒːzedɒːdæn/
اجاس	/ed͡ʒɒːs/
اجاق	/od͡ʒɒːɢ/
آجر	/ɒːd͡ʒoɾ/
آجری	/ɒːd͡ʒoɾiː/
اجرا	/ed͡ʒɾɒː/
اجرا کردن	/ed͡ʒɾɒːkæɾdæn/
اجماع	/ed͡ʒmɒːʔ/
اجنبی	/æd͡ʒnæbiː/
اچ‌تی‌ام‌ال	/et͡ʃtiːemel/
آچمز	/ɒːt͡ʃmæz/
احتیاج	/ehtiːɒːd͡ʒ/
احتیاج داشتن	/ehtiːɒːd͡ʒdɒːʃtæn/
احترام	/ehteɾɒːm/
احترام گذاشتن	/ehteɾɒːm ɡozɒːʃtæn/
احترام گذاشتن	/ehteɾɒːmɡozɒːʃtæn/
احتياط	/ehtiːɒːt/
احتياط کردن	/entiːɒːtkæɾdæn/
احساس	/ehsɒːs/
احساس کردن	/ehsɒːskæɾdæn/
احضار	/ehzɒːɾ/
احضار کردن	/ehzɒːɾkæɾdæn/
احمق	/æhmæɢ/
احمقانه	/æhmæɢɒːne/
آخ	/ɒːx/
اخبار	/æxbæɾ/
اختیار	/extiːɒːɾ/
اختیار افتادن	/extiːɒːɾoftɒːdæn/
اختیار دادن	/extiːɒːɾdɒːdæn/
اختیار گذاشتن	/extiːɒːɾɡozɒːʃtæn/
اختر	/æxtæɾ/
اختری	/æxtæɾiː/
اختربین	/æxtæɾbiːn/
اخترشناس	/æxtæɾʃenɒːs/
اخترمار	/æxtæɾmɒːɾ/
اختصاص	/extesɒːs/
اختصاص دادن	/extesɒːsdɒːdæn/
اختصاص داشتن	/extesɒːsdɒːʃtæn/
اختلاط	/extelɒːt/
اختلاط کردن	/extelɒːtkæɾdæn/
اختلاف	/extelɒːf/
اخته	/æxte/
یاخته	/jæxte/
آخر	/ɒːxæɾ/
اخیرا	/æxiːɾæn/
اخراج	/exɾɒːd͡ʒ/
اخراج کردن	/exɾɒːd͡ʒkæɾdæn/
آخرت	/ɒːxeɾæt/
آخر هفته	/ɒːxæɾe hæfte/
آخر هفته	/ɒːxeɾe hæfte/
آخشیج	/ɒːxʃiːd͡ʒ/
اخطار	/extɒːɾ/
اخطار کردن	/extɒːɾkæɾdæn/
اخلاق	/æxlɒːɢ/
اخم	/æxm/
اخم کردن	/æxmkæɾdæn/
آخور	/ɒːxoɾ/
آخوندک	/ɒːxuːndæk/
یاد	/jɒːd/
ادا	/ædɒː/
ادا آمدن	/ædɒːɒːmædæn/
ادا درآوردن	/ædɒːdæɾɒːvæɾdæn/
اداره	/edɒːɾe/
اداره پست	/edɒːɾeje post/
یاد افتادن	/jɒːdoftɒːdæn/
ادا کردن	/ædɒːkæɾdæn/
آدام	/ɒːdɒːm/
یاد آمدن	/jɒːdɒːmædæn/
آدامس	/ɒːdɒːms/
ادامه	/edɒːme/
ادامه یافتن	/edɒːmejɒːftæn/
ادامه دادن	/edɒːmedɒːdæn/
ادامه داشتن	/edɒːmedɒːʃtæn/
ادیان ابراهیمی	/ædjɒːne ebɾɒːhiːmiː/
یاد انداختن	/jɒːdændɒːxtæn/
یادآوری	/jɒːdɒːvæɾiː/
یاد آوردن	/jɒːdɒːvæɾdæn/
یادآوری کردن	/jɒːdɒːvæɾiː kæɾdæn/
یادآوری کردن	/jɒːdɒːvæɾiːkæɾdæn/
ادب	/ædæb/
ادبی	/ædæbiː/
یاد بردن	/jɒːdboɾdæn/
یادبود	/jɒːdbuːd/
یاد دادن	/jɒːd dɒːdæn/
یاد دادن	/jɒːddɒːdæn/
یادداشت	/jɒːddɒːʃt/
یادداشت کردن	/jɒːddɒːʃtkæɾdæn/
ادرار	/edɾɒːɾ/
ادراری	/edɾɒːɾiː/
آدرس	/ɒːdɾes/
ایدز	/ejdz/
آدیس آبابا	/ɒːdiːs ɒːbɒːbɒː/
یادش آمدن	/jɒːdæʃ ɒːmædæn/
ادعا	/eddeʔɒː/
ادعا کردن	/eddeʔɒːkæɾdæn/
یاد کردن	/jɒːdkæɾdæn/
ادکلن	/odkolon/
یادگار	/jɒːdɡɒːɾ/
یادگاری	/jɒːdeɡɒːɾiː/
یاد گرفتن	/jɒːd ɡeɾeftæn/
یاد گرفتن	/jɒːdɡeɾeftæn/
آدم	/ɒːdæm/
آدمی	/ɒːdæmiː/
یاد ماندن	/jɒːdmɒːndæn/
آدم برفی	/ɒːdæmbæɾfiː/
آدم‌خواری	/ɒːdæmxɒːɾiː/
آدینه	/ɒːdiːne/
ایده	/iːde/
ادوکلن	/odokolon/
ادویه	/ædviːje/
ادویه زدن	/ædviːjezædæn/
اذان	/æzɒːn/
اذیت	/æziːjæt/
اذیت کردن	/æziːjætkæɾdæn/
آذر	/ɒːzæɾ/
آذری	/ɒːzæɾiː/
آذربایجانی	/ɒːzæɾbɒːjd͡ʒɒːniː/
آذربایجان	/ɒːzæɾbɒːjed͡ʒɒːn/, /ɒːzæɾbɒːjd͡ʒɒːn/
آذرخش	/ɒːzæɾæxʃ/
یار	/jɒːɾ/
یاری	/jɒːɾiː/
آریایی	/ɒːɾiːjɒːjiː/
ارابه	/æɾɒːbe/, /æɾɾɒːbe/
ایراد	/iːɾɒːd/
ایراد گرفتن	/iːɾɒːdɡeɾeftæn/
آرارات	/ɒːɾæɾæt/
آراستن	/ɒːɾɒːstæn/
آرایش	/ɒːɾɒːjeʃ/
آرایش دادن	/ɒːɾɒːjeʃdɒːdæn/
آرام	/ɒːɾɒːm/
آرامش	/ɒːɾɒːmeʃ/
آرامش بخشیدن	/ɒːɾɒːmeʃbæxʃiːdæn/
آرام شدن	/ɒːɾɒːm ʃodæn/
آرامگاه	/ɒːɾɒːmɡɒːh/
آرام گرفتن	/ɒːɾɒːmɡeɾeftæn/
ایران	/iːɾɒːn/
ایرانی	/iːɾɒːniː/
آرانی	/ɒːɾɒːniː/
آرایه	/ɒːɾɒːje/
ارائه	/eɾɒːʔe/
ارائه دادن	/eɾɒːʔedɒːdæn/
ارائه شدن	/eɾɒːʔeʃodæn/
آرايشگر	/ɒːɾɒːjeʃɡæɾ/
ارت	/eɾt/
ارتباط	/eɾtebɒːt/
ارتداد	/eɾtedɒːd/
ارتش	/æɾteʃ/
ارتفاع	/eɾtefɒːʔ/
ارت کردن	/eɾt kæɾdæn/
ارث	/eɾs/
ارث بردن	/eɾsboɾdæn/
ارث رسیدن	/eɾsɾesiːdæn/
ارث گذاشتن	/eɾsɡozɒːʃtæn/
ارج نهادن	/æɾd͡ʒnæhɒːdæn/
آرخانگلسک	/ɒːɾxɒːnɡelsk/
آرد	/ɒːɾd/
ارد	/oɾd/
یاری دادن	/jɒːɾiːdɒːdæn/
اردیبهشت	/oɾdiːbeheʃt/
اردک	/oɾdæk/
اردنگی 	/oɾdænɡiː/
اردنگی  زدن	/oɾdænɡiːzædæn/
اردو	/oɾduː/
اردو زدن	/oɾduːzædæn/
ارزیابی	/æɾzjɒːbiː/
ارزیابی کردن	/æɾzjɒːbiːkæɾdæn/
ارزان	/æɾzɒːn/
ارزانی	/æɾzɒːniː/
ارزانی داشتن	/æɾzɒːniːdɒːʃtæn/
ارزش	/æɾzeʃ/
ارزشگذاری	/æɾzeʃɡodhæɾiː/
ارزن	/æɾzæn/
آرزو	/ɒːɾezuː/
آرزو داشتن	/ɒːɾezuː dɒːʃtæn/
آرزو داشتن	/ɒːɾezuːdɒːʃtæn/
آرزو كردن	/ɒːɾezuː kæɾdæn/
آرزو کردن	/ɒːɾezuːkæɾdæn/
آرزو کشیدن	/ɒːɾezuːkeʃiːdæn/
آرزومندی	/ɒːɾezuːmændiː/
آرژانتین	/ɒːɾʒɒːntiːn/
ارس	/æɾæs/
ارسال	/eɾsɒːl/
ارسال کردن	/eɾsɒːlkæɾdæn/
ارسطو	/æɾestuː/
آرسنیک	/ɒːɾseniːk/
ارشاد	/eɾʃɒːd/
ارشاد کردن	/eɾʃɒːdkæɾdæn/
ارشمیدس	/æɾʃemiːdes/
ارعابگری	/eɾʔɒːbɡæɾiː/
ارغنون	/æɾɢænuːn/
ارغوانی	/æɾɢævɒːniː/
ارقام رومی	/æɾɢɒːme ɾuːmiː/
ارکاک	/eɾkɒːk/
یاری کردن	/jɒːɾiː kæɾdæn/
ارکستر	/oɾkestɾ/
ایرکوتسک	/iːɾkuːtsk/
ارگ	/oɾɡ/
ارگاسم	/oɾɡɒːsm/
یاریگر	/jɒːɾiːɡæɾ/
آرگون	/ɒːɾɡon/
ایرلند	/ʔiːɾlænd/
ایرلندی	/iːɾlændiː/
آرماگدون	/ɒːɾmæɡedon/
آرمان	/ɒːɾmɒːn/
آرمانی	/ɒːɾmɒːniː/
ارمغان	/æɾmæɢɒːn/
ارمغان دادن	/æɾmæɢɒːndɒːdæn/
ارمنی	/æɾmæniː/
ارمنستان	/æɾmænestɒːn/
ارمود	/æɾmuːd/
ارنبورگ	/oɾenbuːɾɡ/
ارنی ترنگ	/oɾniː toɾænɡ/
آرنج	/ɒːɾænd͡ʒ/
آرنج	/ɒːɾend͡ʒ/
اره	/æɾɾe/
آره	/ɒːɾe/
اره كردن	/æɾɾe kæɾdæn/
اره کشیدن	/æɾɾekeʃiːdæn/
اره‌ماهی	/æɾɾemɒːhiː/
اره و اوره و شمسی کوره	/ɒːɾe uːɾe ʃæmsiː kuːɾe/
ایروان	/eɾævɒːn/
اروپا	/oɾuːpɒː/
اروپای مرکزی	/oɾuːpɒːje meɾkæziː/
اروتیکی	/eɾotiːkiː/
اروس	/eɾuːs/
یاروسلاول	/jæɾuːslɒːvl/
آروغ	/ɒːɾoɢ/
آروغ زدن	/ɒːɾoɢzædæn/
اروگوئه	/oɾuːɡuːʔe/
ارومیه	/oɾuːmiːe/
از	/æz/
آزاد	/ɒːzɒːd/
آزادی	/ɒːzɒːdiː/
آزادی بیان	/ɒːzɒːdiːje bejɒːn/
آزاد ساختن	/ɒːzɒːd sɒːxtæn/
آزاد کردن	/ɒːzɒːd kæɾdæn/
آزادماهی	/ɒːzɒːdmɒːhiː/
آزادی مطبوعات	/ɒːzɒːdiːje mætbuːʔɒːt/
آزار	/ɒːzɒːɾ/
آزار دادن	/ɒːzɒːɾdɒːdæn/
از بر	/æz bæɾ/
ازبکی	/ozbækiː/
ازبکستان	/ozbækestɒːn/
از حالا	/æz hɒːlæn/
از حفظ	/æz hefz/
ایزد	/iːzæd/
از دست دادن	/æz dæst dɒːdæn/
یازده	/jɒːzdæh/
ازدواج	/ezdevɒːd͡ʒ/
ازدواج کردن	/ezdevɒːd͡ʒ kæɾdæn/
ازدواج کردن	/ezdevɒːd͡ʒkæɾdæn/
از طرف ديگر	/æz tæɾæf dîɡæɾ/
از کی	/æz kej/
از کی تا حالا	/æz kej tɒː hɒːlɒː/
ازگیل	/æzɡiːl/
آزمایش	/ɒːzmɒːjeʃ/
آزمایشگاه	/ɒːzmɒːjeʃɡɒːh/
آزمودن	/ɒːzmuːdæn/
آزمون‌پذیر	/ɒːzmuːnpæziːɾ/
آزمون‌پذیری	/ɒːzmuːnpæziːɾiː/
ازن	/ozon/
ازوپ	/ezuːp/
آژان پرووکاتور	/ɒːʒɒːn pɾovokɒːtoɾ/
آژانس ازدواج	/ɒːʒɒːns ezdevɒːd͡ʒ/
اژدر	/æʒdæɾ/
اژدها	/eʒdehæ/
اژدهای بالدار	/eʒdehæje bældæɾ/
اژدهابلم	/eʒdehæbælæm/
ایژوسک	/iːʒevsk/
یاس	/jɒːs/
آسیا	/ɒːsiːjɒː/
آسیای جنوبی	/ɒːsiːjɒːje d͡ʒonuːbiː/
اس ام اس	/esemes /
اس ام اس	/esemes/
اس ام اس زدن	/esemeszædæn/
اس ام اس کردن	/esemeskæɾdæn/
آسان	/ɒːsɒːn/
اسب	/æsb/
آسیب	/ɒːsiːb/
اسباب	/æsbɒːb/
اسب آبی	/æsbe ɒːbiː/
اسباب بازی	/æsbɒːb bɒːziː/
اسباب کشیدن	/æsbɒːbkeʃiːdæn/
آسیب خوردن	/ɒːsiːbxoɾdæn/
اسب دریایی	/æsbe dæɾjɒːjiː/
آسیب رسیدن	/ɒːsiːbɾesiːdæn/
آسیب زدن	/ɒːsiːbzædæn/
آسیب‌شناسی	/ɒːsiːbʃenɒːsiː/
اسپارت	/espɒːɾt/
اسپانیا	/espɒːniːjæ/
اسپانیایی	/espɒːniːjɒːiː/
اسپرانتو	/espeɾɒːnto/
اسپرز	/espoɾz/
اسپریس	/æspɾiːs/
اسپرماتوزئید	/espeɾmɒːtozoʔiːd/
اسپست	/espest/, /æspest/
اسپین	/espiːn/
است	/æst/
ایست	/est/
استاتین	/æstɒːtiːn/
استاد	/ostɒːd/
ایستادن	/iːstɒːdæn/
استارباکس	/estɒːɾbɒːks/
استارت	/estɒːɾt/
استارت زدن	/estɒːɾtzædæn/
استانبول	/estɒːmbuːl/
استاندارد	/estɒːndɒːɾd/
آستانه	/ɒːstɒːne/
استثمار	/estesmɒːɾ/
استثمار شدن	/estesmɒːɾʃodæn/
استثنایی	/estesnæeiː/
استخدام	/estexdɒːm/
استخدام شدن	/estexdɒːmʃodæn/
استخدام کردن	/estexdɒːmkæɾdæn/
استخر	/estæxɾ/
استخوانی	/ostexɒniː/
استخوان	/ostexwɒːn/
استخوان	/ostoxɒːn/
استخوان‌بندی	/ostoxɒːnbændiː/
استخون	/ostoxuːn/
ایستر	/iːstæɾ/
استراتژی	/esteɾɒːteʒiː/
استراتفورد	/estɾɒːtfoɾd/
استراحت	/esteɾɒːhæt/
استراحت کردن	/esteɾɒːhætkæɾdæn/
استرالیا	/ostɾɒːliːjæ/
آستریکس	/ɒːsteɾjks/
استرونسیم	/æstɾuːnsiːm/
استعداد	/esteʔdɒːd/
استعمارگری	/esteʔmɒːɾɡæɾiː/
استفاده	/estefɒːde/
استفاده شدن	/estefɒːdeʃodæn/
استفاده کردن	/estefɒːde kæɾdæn/
استفاده کردن	/estefɒːdekæɾdæn/
استفراغ	/estefɾɒːɢ/
استفراغ افتادن	/estefɾɒːɢoftɒːdæn/
استفراغ کردن	/estefɾɒːɢkæɾdæn/
استقبال	/esteɢbɒːl/
استقبال کردن	/esteɢbɒːlkæɾdæn/
استکان	/estekɒːn/
استکان زدن	/estekɒːnzædæn/
ایستگاه	/iːstɡɒːh/
ایستگاه اتوبوس	/iːstɡɒːhe otobuːs/
استمنا کردن	/estemnɒː kæɾdæn/
استنباط	/estembɒːt/
استنباط شدن	/estembɒːtʃodæn/
استنطاق	/estentɒːɢ/
استنطاق کردن	/estentɒːɢkæɾdæn/
استنطاق کشیدن	/estentɒːɢkeʃiːdæn/
استوار بودن	/ostovɒːɾ buːdæn/
استوخودوس	/ostoxuːddos/
استودیو	/estuːdiːjuː/
استونی	/estuːniː/
استونیایی	/estuːniːjɒːjiː/
استونیائی	/estuːniːjɒːʔiː/
اسحاق	/eʃɒːɢ/
اسیر	/æsiːɾ/
اسرائیل	/esɾɒːʔiːl/
اسرائیلی	/esɾɒːʔiːliː/
یاس شیروانی	/jɒːse ʃiːɾvɒːniː/
آسفالت	/ɒːsfɒːlt/
آسفالت شدن	/ɒːsfɒːltʃodæn/
آسفالت کردن	/ɒːsfɒːltkæɾdæn/
اسفناج	/esfenɒːd͡ʒ/
اسفنج	/esfænd͡ʒ/
اسفند	/esfænd/
اسقف	/osɢof/
اسکاتلند	/eskɒːtlænd/
اسکار	/oskæɾ/
ایسیک کول	/iːstiːk kuːl/
اسکلت	/eskelet/
اسکناس	/eskenɒːs/
اسکندر	/eskændæɾ/
اسکندر مقدونی	/eskændæɾ mæɢeduːniː/
اسکوپیا	/iːskopiːjɒː/
اسکوپیه	/iːskopiːjæh/
اسلام	/eslɒːm/
اسلامی	/eslɒːmiː/
اسلام‌آباد	/eslɒːmɒːbɒːd/
اسلام‌گرا	/eslɒːmɡæɾɒː/
اسلام‌گرایی	/eslɒːmɡæɾɒːjiː/
اسلام‌هراسی	/eslɒːmhæɾɒːsiː/
اسلاو	/eslɒːv/
اسلحه گرم	/æslæhe ɡæɾm/
اسلیمی	/esliːmiː/
ایسلند	/ʔiːslænd/
ایسلندی	/ʔiːslændiː/
اسلو	/oslo/
اسلوونی	/esloveniː/
اسلوونیایی	/esluːveniːjɒːjiː/
اسلوونیائی	/esluːveniːjɒːʔiː/
اسم	/esm/
آسمان	/ɒːsemɒːn/, /ɒːsmɒːn/
اسمبلی	/æsembeliː/
اسمیت	/iːsmiːt/
اسم جمع	/esmed͡ʒæmʔ/
اسم فامیل	/esme fɒːmiːl/
اسمیم	/osmiːjom/
یاسمن	/jɒːsæmen/
یاسمین	/jɒːsæmiːn/
یاسمون	/jɒːsæmuːn/
اسنوکر	/esnuːkeɾ/
اسهال	/eshɒːl/
اسهال زدن	/eshɒːlzædæn/
اسوار	/æsvæɾ/
اسير	/æsiːɾ/
اشاره	/eʃɒːɾe/
اشاره کردن	/eʃɒːɾekæɾdæn/
آشامیدن	/ɒːʃɒːmiːdæn/
آشامیدنی	/ɒːʃɒːmiːdæniː/
ایشان	/iːʃɒːn/
آشیانه	/ɒːʃjɒːne/
آشیانه گرفتن	/ɒːʃjɒːneɡeɾeftæn/
آشپز	/ɒːʃpæz/
آشپزی	/ɒːʃpæziː/
آشپزخانه	/ɒːʃpæzxɒːne/
آشتی	/æʃtiː/
آشتی	/ɒːʃtiː/
اشتیاق	/eʃtiːjɒːɢ/
اشتباه	/eʃtebɒːh/
اشتباه شدن	/eʃtebɒːhʃodæn/
اشتباه کردن	/eʃtebɒːhkæɾdæn/
آشتی دادن	/æʃtiːdɒːdæn/
اشتراوس	/eʃtɾɒːuːs/
آشتی کردن	/æʃtiːkæɾdæn/
آشخال	/ɒːʃxɒːl/
اشغال	/eʃɢɒːl/
آشغال	/ɒːʃɢɒːl/
اشغال کردن	/eʃɢɒːlkæɾdæn/
اشک	/æʃk/
آشکار کردن	/ɒːŝkɒːɾ kæɾdæn/
اشک ریختن	/æʃkɾiːxtæn/
آشنا	/ɒːʃenɒː/
آشنا	/ɒːʃnɒː/
آشنایی	/ɒːʃnɒːjiː/
آشنایی دادن	/ɒːʃnɒːjiːdɒːdæn/
آشنا شدن	/ɒːʃnɒː ʃodæn/
آشوب	/ɒːʃuːb/
آشور	/ɒːʃuːɾ/
اصابت	/esɒːbæt/
اصابت کردن	/esɒːbætkæɾdæn/
اصرار	/esɾɒːɾ/
اصرار کردن	/esɾɒːɾkæɾdæn/
اصفهان	/esfæhɒːn/
اصل	/æsl/
اصلی	/æsliː/
اصلاح	/eslɒːh/
اصلاح کردن	/eslɒːhkæɾdæn/
اصول اخلاق	/osuːle æxlɒːɢ/
اضافه	/ezɒːfe/
اض پوشت ب ژلو گوضشتن	/æz poʃt be d͡ʒelo ɡozæʃtæn/
اطاعت	/etɒːʔæt/
اطاعت کردن	/etɒːʔætkæɾdæn/
اطاق خواب	/otɒːɢe xɒːb/
اطلاع	/ettelɒːʔ/
اطلاعات	/ettelɒːʔɒːt/
اطلس	/ætlæs/
اطمینان	/etmiːnɒːn/
اطمینان دادن	/etmiːnɒːndɒːdæn/
اطمینان داشتن	/etmiːnɒːndɒːʃtæn/
اطو	/otuː/
اظهار	/æzhɒːɾ/
اظهار	/ezhɒːɾ/
اظهار کردن	/ezhɒːɾkæɾdæn/
اظهارنظر	/ezhɒːɾe næzæɾ/
اظهارنظر کردن	/ezhɒːɾenæzæɾkæɾdæn/
اعتبار	/eʔtebɒːɾ/
اعتراف	/eʔteɾɒːf/
اعتراف کردن	/eʔteɾɒːfkæɾdæn/
اعتصاب	/eʔtesɒːb/
اعتقاد	/eʔteɢɒːd/
اعتقاد داشتن	/eʔteɢɒːddɒːʃtæn/
اعتماد	/eʔtemɒːd/
اعتماد کردن	/eʔtemɒːdkæɾdæn/
اعتنا	/eʔtenɒː/
اعتنا کردن	/eʔtenɒːkæɾdæn/
اعدام	/eʔdɒːm/
اعدام کردن	/eʔdɒːm kæɾdæn/
اعضا	/æzɒː/
اعلام	/eʔlɒːm/
اعلام شدن	/eʔlɒːmʃodæn/
اعلام کردن	/eʔlɒːmkæɾdæn/
اعلامیه	/eʔlɒːmiːje/
اعلامیه زدن	/eʔlɒːmiːjezædæn/
آغا	/ɒːɢɒː/
آغاز	/ɒːɢɒːz/
آغاز شدن	/ɒːɢɒːzʃodæn/
اغاز کردن	/æɢɒːz kæɾdæn/
اغلب	/æɢlæb/
اغوز	/uːɢuːz/
آغوش	/ɒːɢuːʃ/
آغوش کشیدن	/ɒːɢuːʃkeʃiːdæn/
آغوش گرفتن	/ɒːɢuːʃɡeɾeftæn/
اف‌بی‌آی	/efbiːɒːj/
آفت	/ɒːfæt/
آفتاب	/ɒːftɒːb/
آفتابی	/ɒːftɒːbiː/
آفتاب‌پرست	/ɒːftɒːbpæɾæst/
آفتابگیر	/ɒːftɒːbɡiːɾ/
آفتابگیر زدن	/ɒːftɒːbɡiːɾzædæn/
آفتاب گرفتن	/ɒːftɒːbɡeɾeftæn/
آفتابه	/ɒːftɒːbe/
افتادن	/oftɒːdæn/
افتخار	/eftexɒːɾ/
افتخار کردن	/eftexɒːɾkæɾdæn/
افترا	/efteɾɒː/
افترا خوردن	/efteɾɒːxoɾdæn/
افترا زدن	/efteɾɒːzædæn/
یافتن	/jɒːftæn/
آفریدن	/ɒːfæɾiːdæn/
آفریقا	/ɒːfɾiːɢɒː/
آفریقایی	/ɒːfɾiːɢɒːjiː/
آفریقای جنوبی	/ɒːfɾiːɢɒːje d͡ʒonuːbiː/
آفریکانز	/ɒːfɾiːkɒːnz/
آفریکانس	/ɒːfɾiːkɒːns/
افروختن	/æfɾuːxtæn/
افزاره	/æfzɒːɾe/
افزایش	/æfzɒːjeʃ/
افزایش	/æfzɒːjeŝ/
افزایش دادن	/æfzɒːjeʃdɒːdæn/
افزایش گرفتن	/æfzɒːjeʃɡeɾeftæn/
افزایه	/æfzɒːje/
افزودن	/æfzuːdæn/
افسس	/æfss/
افسوس	/æfsuːs/
افشردن	/æfʃoɾdæn/
افشک	/æfʃæk/
افشنگ	/æfʃænɡ/
افغان	/æfɢɒːn/
افغانی	/æfɢɒːniː/
افغانستان	/æfɢɒːnestɒːn/
افق	/ofoɢ/
افلاطون	/æflɒːtuːn/
افندی	/efendiː/
افیون	/æfjuːn/
آی‌فون	/ɒːjfuːn/
آقا	/ɒːɢɒː/
آقا	/ɒːĝɒː/
آقاپسر	/ɒːɢɒːpesæɾ/
اقیانوس	/oɢjɒːnuːs/
اقیانوس آرام	/oɢjɒːnuːse ɒːɾɒːm/
اقیانوس اطلس	/oɢjɒːnuːse ætlæs/
اقیانوس منجمد جنوبی	/oɢjɒːnuːse mond͡ʒæmede d͡ʒænuːbiː/
اقیانوس منجمد شمالی	/oɢjɒːnuːse mond͡ʒæmede ʃemɒːliː/
اقیانوسیه	/oɢjɒːnuːsiːje/
اقیانوس هند	/oɢjɒːnuːse hend/
اقتصاد	/eɢtesɒːd/
اقرار	/eɢɾɒːɾ/
اقرار کردن	/eɢɾɒːɾkæɾdæn/
اقریطس	/eɢɾiːts/
اقلا	/æɢælæn/
اقلیم	/eɢliːm/
اقلیم‌شناسی	/eɢliːmʃenɒːsiː/
یاقوتی	/jɒːɢuːtiː/
اکتبر	/oktobɾ/
اکتفا	/ektefɒː/
اکتفا کردن	/ektefɒːkæɾdæn/
اکتینیم	/æktiːniːjom/
اکتیو	/æktiːv/
اکسید	/oksiːd/
اکسیر	/eksiːɾ/
اکسیژن	/oksiːʒen/
آکندن	/ɒːkændæn/
اکنون	/æknuːn/
اکوادور	/ekvɒːdoɾ/
آکواریوم	/ɒːkvɒːɾjuːm/
یاکوتسک	/jækuːtsk/
آکوردئون	/ɒːkoɾdeʔon/
اکوسیستم	/ekuːsiːstem/
آگاهی	/ɒːɡɒːhiː/
آگاهی دادن	/ɒːɡɒːhiːdɒːdæn/
اگر	/æɡæɾ/
آگرا	/ɒːɡɾɒː/
اگرچه	/æɡæɾt͡ʃe/
آگره	/ɒːɡɾe/
اگر و فقط اگر	/æɡæɾ væ fæɢæt æɡæɾ/
اگزیستانسیالیسم	/eɡziːstɒːnsiːɒːliːsm/
آگهی	/ɒːɡæhiː/
آگهی دادن	/ɒːɡæhiːdɒːdæn/
ایگوانا	/iːɡvɒːnɒː/
آلاباما	/ɒːlɒːbɒːmɒː/
آلاسکا	/ɒːlæskæ/
الاغ	/olɒːɢ/
الان	/ælɒːn/
آلبالو	/ɒːlbɒːluː/
آلبانی	/ɒːlbɒːniː/
البته	/ælbæte/
البروس	/elbɾuːs/
آلپ	/ɒːlp/
آلت	/ɒːlæt/
یالتا	/jɒːltæ/
آلتای	/ɒːltɒːj/
آلت تناسلی مرد	/ɒːlæte tænɒːsoliːje mæɾd/
التزام	/eltezɒːm/
التزامی	/eltezɒːmiː/
التزام دادن	/eltezɒːmdɒːdæn/
التماس	/eltemɒːs/
التماس کردن	/eltemɒːskæɾdæn/
الجزایر	/æld͡ʒæzɒːjeɾ/
الجزیره	/æld͡ʒæziːɾe/
الجزیره	/æld͡ʒæzîɾe/
الحمد لله	/ælhæmdoleʔllɒːh/
الیستا	/eliːstɒː/
آلش	/ɒːlæʃ/
الف	/ælef/
آلفا	/ɒːlfɒː/
الفبا	/ælefbɒː/
الفبای سیریلیک	/ælefbɒːje siːɾiːliːk/
القاعده	/ælɢɒːde/
الکترومغناطیس	/elektɾomæɢnɒːtiːs/
الکترونی	/elekteɾoniː/
الکترون	/elektɾon/
الکترونیک	/elekteɾoniːk/
الکل	/ælkol/
الکلی	/ælkoliː/
الگو	/olɡuː/
الگوریتم	/ælɡoɾiːtm/
الگو زدن	/olɡuːzædæn/
الگو کشیدن	/olɡuːkeʃiːdæn/
الله	/ællɒːh/
الله آباد	/ællɒːhɒːbɒːd/
الله اکبر	/ællɒːho ækbæɾ/
الماس	/ælmɒːs/
آلمانی	/ɒːlmæniː/
آلمان	/ɒːlmɒːn/
آلمان شرقی	/ɒːlemɒːn ʃæɾɢiː/
المپ	/olæmp/
المپیک	/olæmpiːk/
الهیات	/elæhiːjɒːt/
الهام	/elhɒːm/
الهام شدن	/elhɒːmʃodæn/
الو	/ælo/
آلو	/ɒːluː/
آلو بخارا	/ɒːluː boxɒːɾɒː/
آلوچه جنگلی	/ɒːluːt͡ʃe d͡ʒænɡæliː/
آلومینیم	/ɒːluːmiːniːjom/
ام	/æm/
ام	/em/
اما	/æmmɒː/
اما	/ɒːmmæ/
آماج	/ɒːmɒːd͡ʒ/
آماج گرفتن	/ɒːmɒːd͡ʒɡeɾeftæn/
آماده	/ɒːmɒːdæ/, /ɒːmɒːde/
امارات عربی متحده	/emɒːɾɒːt æɾæbiː motæhiːde/
یاماکا	/jɒːmɒːkɒː/
اماکن	/æmɒːken/
امام	/emɒːm/
امان	/æmɒːn/
ایمان	/iːmɒːn/
امان آمدن	/æmɒːnɒːmædæn/
امان آوردن	/æmɒːnɒːvæɾdæn/
ایمان آوردن	/iːmɒːnɒːvæɾdæn/
امانت	/æmɒːnæt/
امانت دادن	/æmɒːnætdɒːdæn/
امانت گرفتن	/æmɒːnætɡeɾeftæn/
امان دادن	/æmɒːndɒːdæn/
امیب	/æmiːb/
امپراتوری روم	/empeɾɒːtuːɾiːje ɾuːm/
امپراتوری عثمانی	/empeɾɒːtuːɾiː ʔosmɒːniː/
امپراطوری	/empɾɒːtuːɾiː/
امپریالیسم	/æmpeɾiːjɒːliːsm/
آمپول	/ɒːmpuːl/
آمپول زدن	/ɒːmpuːlzædæn/
امت	/ommæt/
امتحان	/emtehɒːn/
امتحان دادن	/emtehɒːndɒːdæn/
آمیختن	/ɒːmiːxtæn/
آمیخته	/ɒːmiːxtæ/
آمیخته	/ɒːmiːxtæ/, /ɒːmiːxte/
امید	/omiːd/
آمدن	/ɒːmædæn/
امیدوار بودن	/omiːdvɒːɾ buːdæn/
امر	/æmɾ/
امری	/æmɾiː/
امیر	/æmiːɾ/
آمریکا	/ɒːmɾiːkɒː/
آمریکایی	/ɒːmɾiːkɒːjiː/
آمریکای جنوبی	/ɒːmɾiːkɒːje d͡ʒænuːbiː/
آمریکایی‌سازی	/ɒːmɾiːkɒːjiːsɒːziː/
آمریکای شمالی	/ɒːmɾiːkɒːje ʃomɒːliː/
آمریکیوم	/ɒːmeɾiːkiːjom/
امرود	/æmɾuːd/
امروز	/emɾuːz/
امروز صبح	/emɾuːz sobh/
امروز غروب	/emɾuːz ɢoɾuːb/
امروزه	/emɾuːze/
آمیزش	/ɒːmiːzeʃ/
آمیزش جنسی	/ɒːmiːzeʃe d͡ʒensiː/
آمیزش جنسی مقعدی	/ɒːmiːzeʃe d͡ʒensiːje mæɢʔædiː/
آمیزه	/ɒːmiːzæ/, /ɒːmiːze/
امسال	/emsɒːl/
امشب	/emʃæb/
امضا	/emzɒː/
امکان	/emkɒːn/
امگا	/omeɡɒː/
ایمیل	/iːmejl/
ایمیل زدن	/iːmejlzædæn/
ایمیل کردن	/iːmejlkæɾdæn/
آمین	/ɒːmiːn/
امنیت	/æmniːjæt/
آموختن	/ɒːmuːxtæn/
آمودریا	/ɒːmuːdæɾjɒː/
آمو دریا	/ɒːmuː dæɾjɒː/
آمور	/ɒːmuːɾ/
آموزش	/ɒːmuːzeʃ/
آموزش دادن	/ɒːmuːzeʃdɒːdæn/
آموزشگاه	/ɒːmuːzeʃɡæh/
آموزگار	/ɒːmuːzɡɒːɾ/
ان	/æn/
این	/iːn/
آیین	/ɒːjiːn/
آن	/ɒːn/
آناپا	/ɒːnɒːpɒː/
آناتولی	/ɒːnætoliː/
آناتومی	/ɒːnætomiː/
انار	/ænɒːɾ/
آنان	/ɒːnɒːn/
آناناس	/ɒːnɒːnɒːs/
انبار	/ænbɒːɾ/
انبار شدن	/ænbɒːɾʃodæn/
انبار کردن	/ænbɒːɾkæɾdæn/
انبار مهمات	/ænbɒːɾe mohemmɒːt/
انباره	/ænbæɾe/
انباز	/ænbɒːz/
انباز شدن	/ænbɒːz ʃodæn/
انباشتن	/ænbɒːʃtæn/
آنی	/بلافاصله/
انبه	/ænbe/
این به اون در	/iːn be on dæɾ/
انتخابات	/entexɒːbɒːt/
اینترلینگو	/iːnteɾliːnɡuːæ/
انترناسیونال	/enteɾnɒːsjuːnɒːl/
اینترنت	/iːnteɾnet/
انتظار داشتن	/entezæɾ dæʃtæn/
انتظار داشتن	/entezɒːɾ dɒːʃtæn/
انتقاد	/enteɢɒːd/
انتقاد شدن	/enteɢɒːdʃodæn/
انتقاد کردن	/enteɢɒːdkæɾdæn/
انتقام	/enteɢɒːm/
انتقام گرفتن	/enteɢɒːmɡeɾeftæn/
انتگرال	/ænteɡɾɒːl/
انتگرال گرفتن	/ænteɡɾɒːlɡeɾeftæn/
آنتیگوا و باربودا	/ɒːntiːɡvɒː væ bɒːɾbuːdɒː/
انتیموان	/æntiːmoɒːn/
آنتن	/ɒːnten/
آنتن زدن	/ɒːntenzædæn/
انتها	/entehæ/
اینجا	/iːnd͡ʒɒː/
انجام	/ænd͡ʒɒːm/
انجام دادن	/ænd͡ʒɒːmdɒːdæn/
انجام رساندن	/ænd͡ʒɒːmɾesɒːndæn/
انجام گرفتن	/ænd͡ʒɒːmɡeɾeftæn/
انجیر	/ænd͡ʒiːɾ/
انجیل	/end͡ʒiːl/
انجمن	/ænd͡ʒomæn/
انجيلي	/end͡ʒiːliː/
انداختن	/ændɒːxtæn/
اندازه	/ændɒːze/
اندازه زدن	/ændɒːzezædæn/
اندازه شدن	/ændɒːzeʃodæn/
اندازه کردن	/ændɒːzekæɾdæn/
اندازه‌گیر	/ændɒːzeɡiːɾ/
اندازه‌گیری	/ændɒːzeɡiːɾiː/
اندازه گرفتن	/ændɒːzeɡeɾeftæn/
اندام	/ændɒːm/
اندام	/hændɒːm/
اندر	/ændæɾ/
اندریاس	/ændɾiːjɒːs/
اندرز	/ændæɾz/
اندرز دادن	/ændæɾzdɒːdæn/
اندروا	/ændæɾvɒː/
اندرون	/ændæɾuːn/
اندیشیدن	/ændiːʃiːdæn/
اندیشه	/ændiːʃe/
اندیشه	/ændiːŝæ/, /ændiːŝe/
اندلس	/ændælos/
آینده	/ɒːjænde/
آندورا	/ɒːndoɾɒː/
اندونزی	/iːndoneziː/
اندونزیایی	/ændonesiːjejiː/
اندونزیایی	/enduːneziːjɒːjiː/
انرژی	/eneɾʒiː/
انرژی هسته‌ای	/eneɾʒiːje hæsteʔiː/
انزال	/enzɒːl/
انس	/ons/
انسان	/ensɒːn/
انسان جایزالخطاست	/ensæn d͡ʒɒːjezol xætæst/
انس گرفتن	/onsɡeɾeftæn/
انسولین	/ensuːliːn/
ان‌شاءالله	/enʃɒːʔællɒːh/
انفورماتیک	/ænfoɾmɒːtiːk/
انقلاب	/enɢelɒːb/
آنکارا	/ɒːnkæɾæ/
انگ	/ænɡ/
انگاشت	/enɡɒːŝt/
انگبین	/ænɡæbiːn/, /ænɡobiːn/
یانگتسه	/jænɡtse/
انگیختن	/ænɡiːxtæn/
انگ زدن	/ænɡzædæn/
انگشت	/ænɡoʃt/
انگشت پا	/ænɡoʃte pɒː/
انگشت زدن	/ænɡoʃtzædæn/
انگلیسی	/enɡeliːsiː/
انگلیسی آمریکایی	/enɡeliːsiːje ɒːmɾiːkɒːjiː/
انگلستان	/enɡelestæn/
انگلیسی قدیم	/enɡeliːsiː ɢædiːm/
انگور	/ænɡuːɾ/
آنگولا	/ɒːnɡuːlɒː/
انگوین	/ænɡoviːn/
یانگون	/jɒːnɡon/
انگيختار	/ænɡiːxtɒːɾ/
انیمی	/æniːme/
این ماه	/iːn mɒːh/
انیمیشن ژاپنی	/æniːme ʒɒːponiː/
آیینه	/ɒːjiːne/
آنها	/ɒːnhɒː/
این هفته	/iːn hæfte/
آه	/ɒːh/
آها	/ɒːhɒː/
آهار	/ɒːhɒːɾ/
آهار زدن	/ɒːhɒːɾzædæn/
اهریمن	/æhɾiːmæn/
آهسته	/ɒːheste/
آه کشیدن	/ɒːhkeʃiːdæn/
اهمیت	/æhæmmiːjæt/
اهمیت دادن	/æhæmmiːjætdɒːdæn/
آهن	/ɒːhæn/
آهنگ	/ɒːhænɡ/
آهنگ جمله	/ɒːhænɡe d͡ʒomle/
آهنگ داشتن	/ɒːhænɡ dɒːʃtæn/
آهنگ زدن	/ɒːhænɡzædæn/
آهنگساز	/ɒːhænɡsɒːz/
آهو	/ɒːhuː/
!یاهو	/jɒːhuː!/
یاهو	/jɒːhuː/
آهوبره	/ɒːhuːbæɾɾe/
آهو ماده	/ɒːhuːje mɒːde/
او	/oʊ/, /æw/
او	/uː/
آوا	/ɒːvɒː/
آواز	/ɒːvɒːz/
آواز خواندن	/ɒːvɒːz xɒːndæn/
آواز دادن	/ɒːvɒːzdɒːdæn/
آواز زدن	/ɒːvɒːzzædæn/
آواشناسی	/ɒːvæʃenɒːsiː/
اوآگادوگو	/oɒːɡɒːduːɡuː/
ایوان	/ejvɒːn/
ایوان	/iːvɒːn/
اوباما	/obɒːmɒː/
اوت	/uːt/
اوج	/oʊd͡ʒ/
اوج گرفتن	/oʊd͡ʒɡeɾeftæn/
اوج لذت جنسی	/od͡ʒ lezæt d͡ʒensiː/
یاوری	/jɒːvæɾiː/
او را	/uː ɾɒː/
اوراسیا	/oɾɒːsiːjɒː/
اورانیوم	/uːɾɒːnjuːm/
اورپا	/oɾuːpɒː/
اوردن	/ovoɾdæn/
آوردن	/ɒːvæɾdæn/
آوردن	/ɒːvæɾdæn/, /ɒːvoɾdæn/
اورشلیم	/oɾʃæliːm/
اورشلیم مقدس	/oɾʃæliːme moɢæddæs/
یاوری کردن	/jɒːvæɾiːkæɾdæn/
آوریل	/ɒːvɾîl/
اوروپول	/oɾuːpuːl/
اوزبکستان	/uːzbækestɒːn/
اوستا	/ævestɒː/
اوستیا	/osetiːjɒː/
اوستیایی	/osetiːjɒːjiː/
اوستیای جنوبی	/osetiːjɒːje d͡ʒænuːbiː/
اوکراینی	/uːkɾɒːiːniː/
اوکراین	/uːkɾɒːjn/
اوکرائین	/uːkɾɒːʔiːn/
اوگاندا	/uːɡɒːndɒː/
اول	/ævvæl/
اولان‌باتور	/uːlɒːnbɒːtuːɾ/
اولین	/ævvæliːn/
اولین عشق	/ævvæliːne ʔeʃɢ/
آوند	/ɒːvænd/
یاوه گفتن	/jɒːvæ ɡoftæn/
آووکادو	/ɒːvokɒːdo/
آويزان كردن	/ɒːviːzɒːn kæɾdæn/
یائسگی	/jɒːeseɡiː/
آئورت	/ɒːʔoɾt/
یائونده	/jɒːʔuːnde/
اينقدر	/iːnɢædɾ/
بی	/biː/
با	/bɒː/
با احترام	/bɒː ehteɾɒːm/
با این حال	/bæ iːn hɒː/
بابا	/bɒːbɒː/
باباآدم	/bɒːbɒːdæm/
بابا یاگا	/bɒːbɒː jɒːɡɒː/
بیابان	/biːjɒːbɒːn/
بابا نوئل	/bɒːbɒː noʔel/
بیا بریم	/biːjɒː beɾiːm/
بابل	/bɒːbel/
بات	/bɒːt/
باتری	/bɒːtɾiː/
باتنگان	/bɒːtenɡɒːn/
باج	/bɒːd͡ʒ/
باج گرفتن	/bɒːd͡ʒɡeɾeftæn/
باجناق	/bɒːd͡ʒenɒːɢ/
باخ	/bɒːx/
باختر	/bɒːxtæɾ/
باختریان	/bɒːxtæɾiːjɒːn/
باختن	/bɒːxtæn/
باد	/bɒːd/
باید	/bɒːjæd/
بادام	/bɒːdɒːm/
بادام زمینی	/bɒːdɒːme zæmiːniː/
بادام زمینی	/bɒːdɒːm zæmiːniː/
بادام کوهی	/bɒːdɒːm kuːhiː/
بادام هندی	/bɒːdɒːme hendiː/
بادبادک	/bɒːdbɒːdæk/
بادبان	/bɒːdbɒːn/
بادبزن	/bɒːdbezæn/
باد خورشیدی	/bɒːde xoɾʃiːdiː/
باد دادن	/bɒːddɒːdæn/
باد زدن	/bɒːdzædæn/
باد ستاره‌ای	/bɒːde setɒːɾeʔiː/
باد کردن	/bɒːdkæɾdæn/
بادنجان	/bɒːdend͡ʒɒːn/
بادنگان	/bɒːdenɡɒːn/
باده	/bɒːdæ/
بار	/bɒːɾ/
باراک	/bɒːɾɒːk/
باران	/bɒːɾɒːn/
باران آمدن	/bɒːɾɒːn ɒːmædæn/
باران گرفتن	/bɒːɾɒːnɡeɾeftæn/
بار آوردن	/bɒːɾɒːvæɾdæn/
باردار	/bɒːɾdæɾ/
بارداری	/bɒːɾdɒːɾiː/
باریدن	/bɒːɾiːdæn/
بار زدن	/bɒːɾzædæn/
بارکد	/bɒːɾkod/
بار کردن	/bɒːɾkæɾdæn/
بارگذاری	/bɒːɾɡozɒːɾiː/
بارگیری	/bɒːɾɡiːɾiː/
باریم	/bɒːɾiːjom/
بارو	/bɒːɾuː/
باروت	/bɒːɾuːt/
بارود	/bɒːɾuːd/
بارون	/bɒːɾuːn/
باز	/bɒːz/
بازی	/bɒːziː/
بازار	/bɒːzɒːɾ/
بازاریابی	/bɒːzɒːɾjɒːbiː/
بازیافت	/bɒːzjɒːft/
بازالت	/bɒːzɒːlt/
بازتاب	/bɒːztɒːb/
بازتاب دادن	/bɒːztɒːbdɒːdæn/
بازیچه	/bɒːziːt͡ʃe/
باز خواندن	/bɒːz xɒːndæn/
بازداشتن	/bɒːzdɒːʃtæn/
بازدم	/bɒːzdæm/
بازسازی	/bɒːzsɒːziː/
بازی کردن	/bɒːziː kæɾdæn/
بازی کردن	/bɒːziːkæɾdæn/
باز کردن	/bɒːz kæɾdæn/
بازیکن	/bɒːziːkon/
بازیگر	/bɒːziːɡæɾ/
بازگیری	/bɒːzɡiːɾiː/
بازی گرفتن	/bɒːziːɡeɾeftæn/
بازگشت	/bɒːzɡæʃt/
بازگشتن	/bɒːzɡæʃtæn/
بازگو	/bɒːzɡuː/
بازگو کردن	/bɒːzɡuːkæɾdæn/
بازماندن	/bɒːzmɒːndæn/
بازنامیدن	/bɒːznɒːmiːdæn/
بازنده	/bɒːzænde/
بازی‌های المپیک	/bɒːziːhɒːje olæmpiːk/
بازیهای رایانه	/bɒːziːhɒːje ɾɒːjɒːne/
بازو	/bɒːzuː/
بازوبند	/bɒːzuːbænd/
باستان‌شناسی	/bɒːstɒːnʃenɒːsiː/
باسک	/bɒːsk/
باسکی	/bɒːskiː/
باسلق	/bɒːsloɢ/
باش	/bɒːʃ/
باشه	/bɒːʃe/
باعث	/bɒːʔes/
باعث شدن	/bɒːʔesʃodæn/
باغ	/bɒːɢ/
باغ	/bɒːğ/
باغی	/bɒːɢiː/
باغبانی کردن	/bɒːɢbɒːniː kæɾdæn/
باغچه	/bɒːɢt͡ʃe/
باغلاما	/bɒːɢlɒːmɒː/
باغ وحش	/bɒːɢe væhʃ/
بافت	/bɒːft/
بافتن	/bɒːftæn/
بافر	/bɒːfeɾ/
باقالا	/bɒːɢɒːlɒː/
باقلوا	/bɒːɢlævɒː/
باکتریا	/bɒːktæɾiːjɒː/
با یک تیر دو نشان زدن	/bɒː jek tiːɾ do neʃɒːn zædæn/
باکرگی	/bɒːkeɾeɡiː/
باکره	/bɒːkeɾe/
باگ	/bɒːɡ/
بال	/bɒːl/
بالا	/bɒːlɒː/
بالاتر	/bɒːlɒːtæɾ/
بالا زدن	/bɒːlɒːzædæn/
بالا کشیدن	/bɒːlɒːkeʃiːdæn/
بال بال	/bɒːl bɒːl/
بال بال زدن	/bɒːlbɒːlzædæn/
بال زدن	/bɒːlzædæn/
بالش	/bɒːleʃ/
بالعکس	/bɒːlʔæks/
بالکن	/bɒːlkon/
بالگرد	/bɒːlɡæɾd/
بال گرفتن	/bɒːlɡeɾeftæn/
باله	/bɒːle/
بالون	/bɒːluːn/
بام	/bɒːm/
بامبول	/bɒːmbuːl/
بامبول زدن	/bɒːmbuːlzædæn/
بامداد	/bɒːmdɒːd/
بیان	/bæjɒːn/
بیان	/bejɒːn/
بان	/bɒːn/
باینجا	/bæʔiːnd͡ʒɒː/
بیان شدن	/bæjɒːnʃodæn/
بانک	/bɒːnk/
بانک اطلاعات	/bɒːnk ettelɒːʔɒːt/
بانکوک	/bɒːnkok/
بانگ	/bɒːnɡ/
بانگ زدن	/bɒːnɡzædæn/
بانگ کشیدن	/bɒːnɡkeʃiːdæn/
بانو	/bɒːnuː/
بانوج	/bɒːnuːd͡ʒ/
باهاما	/bɒːhɒːmɒː/
با هم	/bɒː hæm/
باهوش	/bɒːhuːʃ/
باور	/bɒːvæɾ/
باور دادن	/bɒːvæɾdɒːdæn/
باور شدن	/bævɒːɾʃodæn/
باور کردن	/bɒːvæɾ kæɾdæn/
باور کردن	/bɒːvæɾkæɾdæn/
ببخشید	/bebæxʃiːd/
ببر	/bæbɾ/
بیپ	/biːp/
بت	/bot/
بتا	/betɒː/
بیت‌المقدس	/bejtolmoɢæddæs/
بی‌تفاوتی	/biːtæfɒːvotiː/
بی‌تفاوتی زدن	/biːtæfɒːvotiːzædæn/
بت‌کده	/botkæde/
بیتلز	/biːtlz/
بتن	/beton/
بیتولا	/biːtolɒː/
بجز	/bed͡ʒoz/
بجنب	/bed͡ʒonb/
بی‌جنس‌گرایی	/biːd͡ʒensɡæɾɒːjiː/
بچ	/bæt͡ʃ/
بچگی	/bæt͡ʃeɡiː/
بچه	/bæt͡ʃt͡ʃe/
بچه قورباغه	/bæt͡ʃt͡ʃeje ɢuːɾbɒːɢe/
بچه گرگ	/bæt͡ʃe ɡoɾɡ/
بحث	/bæhæs/
بحث	/bæhs/
بحث کردن	/bæhskæɾdæn/
بحر	/bæhɾ/
بخار	/boxɒːɾ/
بخاری	/boxɒːɾiː/
بخارا	/boxɒːɾɒː/
بخار شدن	/boxɒːɾʃodæn/
بی‌خیالی	/biːxiːjɒːliː/
بی‌خیالی زدن	/biːxiːjɒːliːzædæn/
بی‌خانمان	/biːxɒːnemɒːn/
بخش	/bæxʃ/
بخشیدن	/bæxʃiːdæn/
بخشیش	/bæxʃiːʃ/
بخشنده	/bæxʃænde/
بخشنده	/bæxŝændæ/, /bæxŝænde/
بخیه	/bæxiːje/
بخیه خوردن	/bæxiːjexoɾdæn/
بخیه زدن	/bæxiːjezædæn/
بخیه کردن	/bæxiːjekæɾdæn/
بی خوابی	/biːxɒːbiː/
بی‌خوابی	/biːxɒːbiː/
بی خوابی کشیدن	/biːxɒːbiːkeʃiːdæn/
بخواه	/bexɒːh/
بخواهی	/bexɒːhiː/
بخواهد	/bexɒːhæd/
بخواهید	/bexɒːhiːd/
بخواهم	/bexɒːhæm/
بخواهیم	/bexɒːhiːm/
بخواهند	/bexɒːhænd/
بد	/bæd/
بدی	/bædiː/
بید	/biːd/
بیدار شدن	/biːdɒːɾ ʃodæn/
بیدار کردن	/biːdɒːɾ kæɾdæn/
بد انجامیدن	/bæd ænd͡ʒɒːmiːdæn/
بدبختی	/bædbæxtiː/
بدبختانه	/bædbæxtɒːne/
بدبختی کشیدن	/bædbæxtiːkeʃiːdæn/
بدبده	/bædbæde/
بدبو	/bædbuː/
بدتر	/bædtæɾ/
بد ترکیب	/bæd tæɾkiːb/
بدرقه	/bædɾæɢe/
بدرقه کردن	/bædɾæɢekæɾdæn/
بدرود	/bedɾuːd/
بدست آوردن	/bedæst ɒːvoɾdæn/
بدعت	/bedʔæt/
بدل	/bædæl/
بدل شدن	/bædælʃodæn/
بدل کردن	/bædælkæɾdæn/
بدلیل	/dæliːl/
بدلیل آن	/bedæliːle ɒːn/
بید مجنون	/biːd mæd͡ʒnuːn/
بدن	/bædæn/
بدهی	/bedehiː/
بدو بدو	/bodo bodo/
بدو بدو زدن	/bodobodozædæn/
بدون	/beduːne/
بر	/bæɾ/
بر	/beɾ/
بری	/bɾiː/
بر	/boɾ/
برای	/bæɾɒːje/
برای اینکه	/bæɾɒːje iːnke/
برابر	/bæɾɒːbæɾ/
برابری	/bæɾɒːbæɾiː/
براتیسلاوا	/bɾɒːtiːslɒːvɒː/
برادر	/bæɾɒːdæɾ/
برادری	/bæɾɒːdæɾiː/
برادرخوانده	/bæɾɒːdæɾxwɒːnde/
برادرزاده	/bæɾɒːdæɾzɒːde/
برادرزن	/bæɾɒːdæɾzæn/
برادرشوهر	/bæɾɒːdæɾʃoʊhæɾ/
براروسی	/bæɾɒːɾuːsiː/
براز	/boɾɒːz/
برازندگی	/bæɾɒːzændæɡiː/
برآمده	/bæɾɒːmæde/
برای من	/bɾɒːje mæn/
بر آن بودن	/bæɾ ɒːn buːdæn/
برانداز	/bæɾændɒːz/
برانداز کردن	/bæɾændɒːzkæɾdæn/
برانکارد	/bɾɒːnkɒːɾd/
برانگیختن	/bæɾɒːnɡiːxtæn/
برانگیزنده	/bæɾɒːnɡiːzændæ/, /bæɾɒːnɡiːzænde/
برای همیشه	/bæɾɒːje hæmiːʃe/
بیراهه	/biːɾɒːhe/
بیراهه زدن	/biːɾɒːhezædæn/
بربخ	/bæɾbæx/
بربط	/bæɾbæt/
بریتانی	/beɾiːtɒːniː/
بریتانیا	/beɾiːtɒːniːjɒː/
بریتانیای کبیر	/beɾiːtɒːniːjɒːje kæbiːɾ/
برتونی	/beɾetoniː/
برتونی	/beɾetuːniː/
برج	/boɾd͡ʒ/
برج حوت	/boɾd͡ʒe hot/
برجستگی	/bæɾd͡ʒæsteɡiː/
برج لندن	/boɾd͡ʒe lændæn/
برچسب	/bæɾt͡ʃæsb/
برچسب زدن	/bæɾt͡ʃæsb zædæn/
برچسب زدن	/bæɾt͡ʃæsbzædæn/
برخاستن	/bæɾxɒːstæn/
برخیزیدن	/bæɾxiːziːdæn/
برخواندن	/bæɾxɒːndæn/
برخورد	/bæɾxoɾd/
بر خوردن	/boɾxoɾdæn/
برداشت	/bæɾdɒːʃt/
برداشتن	/bæɾdɒːʃtæn/
بر داشتن	/bæɾ dɒːʃtæn/
بردن	/boɾdæn/
بریدن	/boɾiːdæn/
برده	/bæɾdæ/
بررسی	/bæɾɾesiː/
برز	/boɾz/
بر زدن	/beɾzædæn/
بر زدن	/boɾzædæn/
برزیل	/beɾziːl/, /beɾeziːl/
برس	/boɾos/
برس کشیدن	/boɾoskeʃiːdæn/
برش	/boɾʃ/
برش	/boɾeʃ/
برشتن	/beɾeʃtæn/
برش خوردن	/boɾeʃxoɾdæn/
برش زدن	/boɾeʃzædæn/
برعکس	/bæɾʔæks/
برف	/bæɾf/
برفی	/bæɾfiː/
برف آمدن	/bæɾf ɒːmædæn/
برف دانه	/bæɾfe dɒːne/
برفک	/bæɾfæk/
برف گرفتن	/bæɾfɡeɾeftæn/
برق	/bæɾɢ/
برق انداختن	/bæɾɢændɒːxtæn/
برق زدن	/bæɾɢzædæn/
برقع	/boɾɢæʔ/
برق گرفتن	/bæɾɢɡeɾeftæn/
برقي	/bæɾɢiː/
برکلیم	/beɾkeliːom/
برگ	/bæɾɡ/
برگ زدن	/bæɾɡzædæn /
برگزیده	/bæɾɡoziːde/
برگزیده شده	/bæɾɡoziːde ʃode/
برگشت	/bæɾɡæʃt/
برگشتی	/bæɾɡæʃtiː/
برگشت خوردن	/bæɾɡæʃtxoɾdæn/
برگشت زدن	/bæɾɡæʃtzædæn/
برگشتن	/bæɾɡæʃtæn/
بر گشتن	/bæɾ ɡæʃtæn/
برگه	/bæɾɡæ/
برگه نخست	/bæɾɡeje noxost/
برلین	/beɾliːn/
برلوسکونی	/beɾluːskuːniː/
بریلیوم	/beɾiːliːjom/
برم	/boɾom/
برمه	/beɾme/
برمه‌ای	/beɾmeʔɒːjiː/
برن	/beɾn/
برنا	/boɾnɒː/
برنامک	/bæɾnɒːmæk/
برنامه	/bæɾnɒːme/
برنامه‌نویسی	/bæɾnɒːmeneviːsiː/
برنج	/beɾend͡ʒ/
برنجی	/beɾend͡ʒiː/
برنجاسف	/beɾend͡ʒɒːsef/
برنده	/bæɾænde/
برنز	/bɾonz/
برنزه	/bɾonze/
بی‌رنگ	/biːɾænɡ/
برّه	/bæɾɾe/
بره	/bæɾɾe/, /bæɾe/
برهمن	/bɾæhmæn/
برهنگی	/beɾæhneɡiː/
برهنه	/beɾæhne/
برو	/bæɾuː/, /boɾuː/
بیروت	/bejɾuːt/
بروت	/boɾuːt/
بروز	/boɾuːz/
بروز دادن	/boɾuːzdɒːdæn/
بروکسل	/bɾuːksel/
برون	/beɾuːn/
بیرون	/biːɾuːn/
بیرونی	/biːɾuːniː/
بیرون زدن	/biːɾuːnzædæn/
بیرون کردن	/biːɾuːnkæɾdæn/
برونئی	/boɾuːnej/
بز	/boz/
بیزاری	/biːzɒːɾiː/
بیزار بودن	/biːzɒːɾ buːdæn/
بیزار کردن	/biːzɒːɾ kæɾdæn/
بیزانس	/biːzɒːns/
بزباش	/bozbɒːʃ/
بزدل	/bozdel/
بزرگ	/bozoɾɡ/
بزرگتر	/bozoɾɡtæɾ/
بزرگسال	/bozoɾɡsɒːl/
بزک	/bæzæk/
بزک کردن	/bæzækkæɾdæn/
بزن به تخته	/bezæn be tæxtæ/
بزه	/beze/
بزودی	/bezuːdiː/
بژ	/beʒ/
بژم	/bæʒm/
بسیار	/besiːjɒːɾ/
بسپار	/bæspɒːɾ/
بست	/bæst/
بیست	/biːst/
بی‌ستاره	/biːsetɒːɾe/
بستر	/bestæɾ/
بست زدن	/bæstzædæn/
بستن	/bæstæn/
بستنی	/bæstæniː/
بسته	/bæste/
بسته بندی	/bestebændiː/
بسته‌بندی کردن	/bæstebændiː kæɾdæn/
بسته بندی کردن	/bestebændiːkæɾdæn/
بیست و پنج سنتی	/biːstopænd͡ʒ sentiː/
بسط	/bæst/
بسط یافتن	/bæstjɒːftæn/
بسط دادن	/bæstdɒːdæn/
بسکتبال	/bæsketbɒːl/
بسکتبالیست	/bæsketbɒːliːst/
بی‌سیم	/biːsiːm/
بی‌سیم زدن	/biːsiːmzædæn/
بیسموت	/biːsmuːt/
بسنده	/bæssænde/
بسنده کردن	/bæsændekæɾdæn/
بشارت	/beʃɒːɾæt/
بشارت دادن	/beʃɒːɾætdɒːdæn/
بیشتر	/biːʃtæɾ/
بشیر	/bæʃiːɾ/
بشقاب	/boʃɢɒːb/
بیشکک	/biːʃkek/
بشکن	/beʃkæn/
بشکن زدن	/beʃkænzædæn/
بی‌شمار	/biːʃomɒːɾ/
بیشه	/biːʃe/
بیطار	/bejtɒːɾ/
بعد	/bæʔd/
بعد	/bæʔde/
بعدا	/bæʔdæn/
بعد از	/bæʔd æz/
بعد از ظهر	/bæʔd æz zohɾ/
بعدتر	/bæʔdtæɾ/
بعضی وقتها	/bæziː væɢthɒː/
بغ	/bæɢ/
بغداد	/bæɢdɒːd/
بغض	/boɢz/
بغض کردن	/boɢzkæɾdæn/
بغض گرفتن	/boɢzɡeɾeftæn/
بغل	/bæɢæl/
بغل زدن	/bæɢælzædæn/
بغل کردن	/bæɢælkæɾdæn/
بغل گرفتن	/bæɢælɡeɾeftæn/
بقال	/bæɢɢɒːl/
بقالی	/bæɢɒːliː/
بی قرار	/biː ɢæɾɒːɾ/
بی قراری	/biː ɢæɾɒːɾiː/
بی کار	/biːkɒːɾ/
بیکاری	/biːkɒːɾiː/
بی‌کاری	/biːkɒːɾiː/
بکار بردن	/be kɒːɾ boɾdæn/
بکارت	/bækɒːɾæt/
بیکاری کشیدن	/biːkɒːɾiːkeʃiːdæn/
بکن	/bokon/
بیگانه	/biːɡɒːne/, /biːɡɒːnæ/
بیگانه‌هراسی	/biːɡɒːnehæɾɒːsiː/
بیگ بن	/biːɡ ben/
بگذریم	/beɡzæɾiːm/
بیل	/biːl/
بلا	/bælɒː/
بیلیارد	/biːljɒːɾd/
بلاروس	/belɒːɾuːs/
بلاگ	/blɒːɡ/
بلال	/bælɒːl/
بلبل	/bolbol/
بلیت	/beliːt/
بلخ	/bælx/
بلد	/bælæd/
بلد بودن	/bælædbuːdæn/
بلدرچین	/beldeɾt͡ʃiːn/
بلروسى	/belæɾuːsiː/
بیل زدن	/biːlzædæn/
بلژیک	/belʒiːk/
بلشویک	/bolʃeviːk/
بلیط	/beliːt/
بلعیدن	/bælʔiːdæn/, /bæliːdæn/
بلغار	/bolɢɒːɾ/
بلغاری	/bolɢɒːɾiː/
بلغارستان	/bolɢɒːɾestɒːn/
بلغراد	/belɢeɾɒːd/
بلغم	/bælɢæm/
بلک‌بری	/blækbeɾiː/
بلگراد	/belɡeɾɒːd/
بلند	/bolænd/
بلند کردن	/bolænd kæɾdæn/
بلندگو	/bolændɡouː/
بلن کردن	/bolæn kæɾdæn/
بله	/bæle/
بلوچی	/bæluːt͡ʃiː/
بلودى مارى	/bluːdiː mɒːɾiː/
بلور	/bellôɾ/
بلوز	/bluːz/
بلوز	/boluːz/
بلوط	/bæluːt/, /boluːt/
بلوف	/bolof/
بلوف خوردن	/bolofxoɾdæn/
بلوف زدن	/bolofzædæn/
بیلیون	/biːljuːn/
بیم	/biːm/
بیمار	/biːmɒːɾ/
بیماری	/biːmɒːɾiː/
بیماری آلزایمر	/biːmɒːɾe ɒːlzɒːjmeɾ/
بیماری زدن	/bebiːmɒːɾiːzædæn/
بیمارستان	/biːmɒːɾestɒːn/
بیمار شدن	/biːmɒːɾ ʃodæn/
بیماری قند	/biːmɒːɾiːje ɢænd/
بمب	/bomb/
بمب خوردن	/bombxoɾdæn/
بمب زدن	/bombzædæn/
بمب ساعتی	/bombe sɒːʔætiː/
بمبئی	/bombæʔiː/
بی‌معنی	/biːmæʔniː/
بی‌مغز	/biːmæɢz/
بیمناک	/biːmnɒːk/
بی‌مهره	/biːmohɾe/
بین	/bejn/
بین	/biːn/
بینی	/biːniː/
بن	/bon/
بینایی	/biːnɒːjiː/
بنیاد	/bonjɒːd/
بین‌المللی	/bejnolmelæliː/
بنانج	/bænɒːnd͡ʒ/
بنیانگذار	/bonjɒːnɡozɒːɾ/
بنتلی	/bentliː/
بند	/bænd/
بندی	/bændiː/
بند	/bănd/
بند آمدن	/bændɒːmædæn/
بند آوردن	/bændɒːvæɾdæn/
بندباز	/bændbɒːz/
بندپایان	/bændpɒːjɒːn/
بندر	/bændæɾ/
بندر سری بگاوان	/bændæɾ seɾiː beɡɒːvɒːn/
بندرگاه	/bændæɾɡɒːh/
بند زدن	/bændzædæn/
بنده	/bændæ/
بنزن	/bænzæn/
بنزین	/benziːn/
بنزین زدن	/benziːnzædæn/
بینش	/biːneʃ/
بنفش	/bænæfʃ/
بنفش روشن	/bænæfʃe ɾoʃæn/
بنفشه	/bænæfʃe/
بنگ	/bænɡ/
بنگاه تجاری	/bonɡɒːhe ted͡ʒɒːɾiː/
بنگلادش	/bænɡlɒːdeʃ/
بینوایی	/biːnævɒːjiː/
بنيانگذاري	/bonjɒːnɡozɒːɾiː/
به	/bæ/
به	/bæh/
به	/be/
به	/beh/
بهی	/behiː/
بها	/bæhɒː/
بها دادن	/bæhɒːdɒːdæn/
به یاد آوردن	/be jɒːd ɒːvæɾdæn/
به یاد داشتن	/be jɒːd dɒːʃtæn/
بهار	/bæhɒːɾ/
بهار عربی	/bæhɒːɾe ʔæɾæbiː/
به امید دیدار	/be omiːde diːdɒːɾ/
به این زودی	/be iːn zuːdiː/
بهانه	/bæhɒːne/
بهانه آوردن	/bæhɒːneɒːvæɾdæn/
بهانه کردن	/bæhɒːnekæɾdæn/
بهانه گرفتن	/bæhɒːneɡeɾeftæn/
بهبود	/behbuːd/
بهبود دادن	/behbuːd dɒːdæn/
بهت	/boht/
بهتان	/bohtɒːn/
بهتان خوردن	/bohtɒːnxoɾdæn/
بهتان زدن	/bohtɒːnzædæn/
بهتر	/behtæɾ/
بهترین	/behtæɾiːn/
بهت زدن	/bohtzædæn/
به حال خود رها کردن	/be hɒːl xuːd ɾæhɒː kæɾdæn/
به خاطر	/be xɒːteɾe/
به دنیا آمدن	/be donjɒː ɒːmædæn/
به دنیا آوردن	/be donjɒː ɒːvæɾdæn/
بهرام	/bæhɾɒːm/
بهره	/bæhɾæ/
بهره	/bæhɾe/
بهره‌برداری	/bæhɾebæɾdɒːɾiː/
بهره‌برداری کردن	/bæhɾebæɾdɒːɾiːkæɾdæn/
بهره بردن	/bæhɾeboɾdæn/
بهره گرفتن	/bæhɾeɡeɾeftæn/
به سلامت	/be sælɒːmæt/
به سمت	/he semet/
بهشت	/beheʃt/
بهشت	‎/beheʃt/
به صحنه آوردن	/besæhne ævæɾdæn/
به قلاب انداختن	/be ɢollɒːb ændɒːxtæn/
به قلاب وصل كردن	/be ɢollɒːb væsl kæɾdæn/
بهمن	/bæhmæn/
به ندرت	/be nodtɾæt/
بهینه	/bæhiːnæ/, /behiːne/
به هنگام	/be hænɡɒːme/
بیهوشی	/biːhuːʃiː/
بیهوشی زدن	/biːhuːʃiːzædæn/
بو	/buː/
بوی	/büj/
بوتان	/buːtɒːn/
بوته	/buːte/
بود	/buːd/
بودا	/buːdɒː/
بوداپست	/buːdɒːpest/
بو دادن	/buːdɒːdæn/
بو داشتن	/bü dɒːʃtæn/
بودن	/buːdæn/
بوییدن	/büjiːdæn/
بور	/boɾ/
بور	/buːɾ/
بورد	/buːɾd/
بورس	/buːɾs/
بوریم	/boɾiːom/
بوره	/buːɾe/
بوزینه	/buːziːne/
بوستان	/buːstɒːn/
بوسیدن	/buːsiːdæn/
بوس کردن	/buːs kæɾdæn/
بوسنیائی	/bosniːjɒːʔiː/
بوسنی و هرزگوین	/bosniː o heɾzeɡoviːn/, /bosniː væ heɾzeɡoviːn/
بوسه	/buːse/
بوسه زدن	/buːsezædæn/
بوش	/buːʃ/
بیوشیمی	/biːoʃiːmiː/
بوف	/buːf/
بوفالو	/buːfɒːlo/
بوق	/buːɢ/
بوق زدن	/buːɢzædæn/
بوقلمون	/buːɢælæmuːn/
بو کردن	/buː kæɾdæn/
بو کردن	/buːkæɾdæn/
بو کشیدن	/buːkeʃiːdæn/
بو گرفتن	/buːɡeɾeftæn/
بوگوتا	/boɡotɒː/
بولیوی	/boliːviː/
بیولوژی	/biːoloʒiː/
بومی	/buːmiː/
بوم‌شناسی	/buːmʃenɒːsiː/
بووم	/buːm/
بوئین	/bhouːʔiːn/
بوئینگ	/boʔiːnɡ/
بوئنوس آیرس	/buːʔenuːs ɒːjɾes/
بي ابهام	/biː ebhɒːm/
بيست	/biːst/
بي صدا	/biːsedɒː/
بيگـاری	/biːɡɒːɾiː/
بيگـاری گرفتن	/biːɡɒːɾiːɡeɾeftæn/
پی	/pej/
پی	/piː/
پا	/pɒː/
پای	/pɒːj/
پای افتادن	/pɒːjoftɒːdæn/
پا افتادن	/pɒːoftɒːdæn/
پایان	/pɒːjɒːn/
پایان یافتن	/pɒːjɒːnjɒːftæn/
پایان دادن	/pɒːjɒːndɒːdæn/
پایان رساندن	/pɒːjɒːnɾesɒːndæn/
پایان رسیدن	/pɒːjɒːnɾesiːdæn/
پایان گرفتن	/pɒːjɒːnɡeɾeftæn/
پایانه اتوبوس	/pɒːjɒːneje otobuːs/
پایبندی	/pɒːbændiː/
پاپ	/pɒːp/
پاپایه	/pɒːpɒːje/
پاپوش	/pɒːpoʃ/
پایتخت	/pɒːjtæxt/, /pɒːjetæxt/
پاتولوژی	/pɒːtuːluːʒiː/
پایتون	/pɒːjton/
پایداشتن	/pɒːjdɒːʃtæn/
پادرد	/pɒːdæɾd/
پادرد زدن	/pɒːdæɾdzædæn/
پادرميانی	/pɒːdæɾmiːɒːniː/
پادرميانی کردن	/pɒːdæɾmiːɒːniːkæɾdæn/
پادزهر	/pɒːdzæhɾ/
پادشاه	/pɒːdeʃɒːh/
پادشاهی	/pɒːdeʃɒːhiː/
پادشاهی	/pɒːdeʃɒːhiː/, /pɒːdʃɒːhiː/
پادشاه	/pɒːdeʃɒːh/, /pɒːdʃɒːh/
پادشاه	/pɒːdʃɒːh/, /pɒːdeʃɒːh/
پادشاهی متحد	/pɒːdeʃɒːhiːje mottæhed/
پاییدن	/pɒːeiːdæn/
پاییدن	/pɒːjiːdæn/
پیاده	/piːjɒːde/
پیاده	/pjɒːde/
پاراگوئه	/pɒːɾɒːɡuːʔe/
پاراماریبو	/pɒːɾɒːmɒːɾiːbuː/
پارامسی	/pɒːɾɒːmesiː/
پاریس	/pɒːɾiːs/
پارس	/pɒːɾs/
پارسی	/pɒːɾsiː/
پارسال	/pɒːɾsɒːl/
پارس کردن	/pɒːɾskæɾdæn/
پارسه	/pɒːɾse/
پارک	/pɒːɾk/
پارک ملی	/pɒːɾke melliː/
پارکینگ	/pɒːɾkiːnɡ/
پارکور	/pɒːɾkuːɾ/
پارو	/pɒːɾuː/
پارو زدن	/pɒːɾuːzædæn/
پیاز	/piːjɒːz/
پاییز	/pɒːjiːz/
پا زدن	/pɒːzædæn/
پاسارگاد	/pɒːsɒːɾɡɒːd/
پای سیب	/pɒːje siːb/
پاسبان	/pɒːsbɒːn/
پاسپورت	/pɒːspoɾt/
پاستا	/pɒːstæ/
پاسخ	/pɒːsox/
پاسخ دادن	/pɒːsox dɒːdæn/
پاسخ دادن	/pɒːsoxdɒːdæn/
پاشا	/pɒːʃɒː/
پاشنه	/pɒːʃne/
پاشنه کفش	/pɒːʃne je kæfʃ/
پاک	/pɒːk/
پاکت	/pɒːkæt/
پاکستان	/pɒːkestɒːn/
پاک کردن	/pɒːk kæɾdæn/
پاک‌کن	/pɒːkken/
پاک‌کن	/pɒːkkon/
پایگاه داده	/pɒːjɡɒːhedɒːde/
پایگاه داده‌ها	/pɒːjɡɒːhe dɒːdehɒː/
پاگودا	/pɒːɡodɒː/
پالایش	/pɒːlɒːjeʃ/
پالایشگاه	/pɒːlɒːjeʃɡɒːh/
پالائی	/pɒːlɒːʔiː/
پالتو	/pɒːlto/
پالکی	/pɒːlkiː/
پیاله	/piːɒːle/
پیاله زدن	/piːɒːlezædæn/
پیام	/pejɒːm/
پامچال	/pɒːmt͡ʃɒːl/
پامیر	/pɒːmiːɾ/
پیامک	/pæjɒːmæk/
پیامک زدن	/pæjɒːmækzædæn/
پایین	/pɒːjiːn/
پاناما	/pɒːnɒːmɒː/
پایین پریدن	/pɒːjiːn pæɾiːdæn/
پانجه​آ	/pænd͡ʒēɒː/
پانچ	/pɒːnt͡ʃ/
پانزده	/pɒːnzdæh/
پانصد	/pɒːnsæd/
پیانو	/piːjɒːno/
پیانو فورته	/piːɒːno foɾte/
پایه	/pɒːjæ/
پایه	/pɒːjæ/, /pɒːje/
پایه	/pɒːjeʔ/
پپسیکولا	/pepsiːkuːlɒː/
پتاسيم	/potɒːsiːm/
پتروسیان	/petɾosjɒːn/
پیتزا	/piːtzɒː/
پتو	/pætuː/
پیچ	/piːt͡ʃ/
پچ‌پچ کردن	/pet͡ʃpet͡ʃ kæɾdæn/
پیچیدن	/piːt͡ʃiːdæn/
پیچیده	/piːt͡ʃiːde/
پیچ زدن	/piːt͡ʃzædæn/
پیچ‌گوشتی	/piːt͡ʃɡuːʃtiː/
پخ	/pæx/
پختن	/poxtæn/
پخته	/poxte/
پخت و پز	/poxtopæz/
پخش	/pæxʃ/
پخش شدن	/pæxʃʃodæn/
پخش کردن	/pæxʃkæɾdæn/
پیدا کردن	/pejdɒː kæɾdæn/
پدیدآورنده	/pædiːdɒːvæɾænde/
پدر	/pedæɾ/
پدربزرگ	/pedæɾbozoɾɡ/
پدربزرگ و مادربزرگ	/pedæɾbozoɾɡ o mɒːdæɾbozoɾɡ/
پدرجد	/pedæɾd͡ʒædd/
پدرخوانده	/pedæɾxwɒːnde/
پدرزن	/pedæɾzæn/
پدرشوهر	/pedæɾʃoʊhæɾ/
پدرشوهر	/pedæɾʃouːhæɾ/
پدر و مادر	/pedæɾ o mɒːdæɾ/
پدر و مادر	/pedæɾ væ mɒːdæɾ/
پذیرایی	/pæziːɾɒːjiː/
پذیرایی کردن	/pæziːɾɒːjiːkæɾdæn/
پذیرائی	/pæziːɾɒːʔiː/
پذیرفتن	/pæziːɾoftæn/
پر	/pæɾ/
پری	/pæɾiː/
پیر	/piːɾ/
پر	/poɾ/
پیرارسال	/piːɾɒːɾsɒːl/
پراگ	/pɾɒːɡ/
پیرامون	/piːɾɒːmuːn/
پیرانا	/piːɾɒːnɒː/
پرانتز	/pæɾɒːntez/
پیراهن	/piːɾɒːhæn/
پرپر	/pæɾ pæɾ/
پرپر زدن	/pæɾpæɾzædæn/
پرتاب	/pæɾtɒːb/
پرتاب کردن	/pæɾtɒːbkæɾdæn/
پرتغالی	/poɾteɢɒːliː/
پرتغال	/poɾtoɢɒːl/
پرتقال	/poɾteɢɒːl/
پرتو	/pæɾtuː/
پرث	/peɾs/
پرچم	/pæɾt͡ʃæm/
پرداختن	/pæɾdɒːxtæn/
پر دادن	/pæɾdɒːdæn/
پردازش داده‌ها	/pæɾdɒːzeʃe dɒːdehhɒː/
پردیس	/pæɾdiːs/
پریدن	/pæɾiːdæn/
پرده	/pæɾde/
پرده کرکره	/pæɾde keɾkeɾe/
پرده گوش	/pæɾdeje ɡuːʃ/
پررنگ	/poɾɾænɡ/
پریروز	/pæɾiːɾuːz/
پر زدن	/pæɾzædæn/
پیرزن	/piːɾezæn/
پرسپولیس	/peɾspoliːs/
پرستار	/pæɾæstɒːɾ/
پرستیژ	/peɾestiːd͡ʒ/
پرستو	/pæɾæstuː/
پرسیدن	/poɾsiːdæn/
پرسش	/poɾseʃ/
پرسه	/pæɾse/
پرسه زدن	/pæɾsezædæn/
پرش	/pæɾeʃ/
پریشب	/pæɾiːʃæb/
پریشتینا	/peɾiːʃtiːnɒː/
پرشکوه	/poɾʃokuːh/
پر کردن	/poɾ kæɾdæn/
پر کشیدن	/pæɾkeʃiːdæn/
پرگار	/pæɾɡɒːɾ/
پرل هاربر	/peɾl hɒːɾboɾ/
پرم	/peɾm/
پرماسیدن	/pæɾmɒːsiːdæn/
پیرمرد	/piːɾemæɾd/
پرنده	/pæɾænde/
پرینه	/peɾiːne/
پرهام	/pæɾhɒːm/
پرهیز	/pæɾhiːz/
پرهیز کردن	/pæɾhiːzkæɾdæn/
پیروی	/pejɾoviː/
پرو	/peɾuː/
پرواربندی	/pæɾvɒːɾbændiː/
پرواز	/pæɾvɒːz/
پرواز دادن	/pæɾvɒːzdɒːdæn/
پرواز کردن	/pæɾvɒːz kæɾdæn/
پرواز کردن	/pæɾvɒːzkæɾdæn/
پروانه	/pæɾvɒːne/
پر و بال	/pæɾ o bɒːl/
پر و بال زدن	/pæɾobɒːlzædæn/
پروتکل اینترنت	/pɾotokol e iːnteɾnet/
پروتون	/pɾuːtuːn/
پروتئین	/poɾoteiːn/
پروژه	/pɾoʒe/
پروستات	/pɾostɒːt/
پروستریکا	/peɾostɾiːkɒː/
پروسه	/pɾose/
پرونده	/pæɾvænde/
پرووکاتور	/pɾovokɒːtoɾ/
پزشک	/pezeʃk/
پزشکی	/pezeʃkiː/
پزشک زایمان	/pezeʃke zɒːjemɒːn/
پزشک زنان	/pezeʃke zænɒːn/
پزشکی قانونی	/pezeʃkiːje ɢɒːnuːniː/
پزشک کودکان	/pezeʃke kuːdækɒːn/
پزنده	/pæzændæ/, /pæzænde/
پژو	/puːʒo/
پژوهیدن	/pæʒuːhiːdæn/
پس	/pæs/
پس	/pos/
پساانسان	/pæsɒːensɒːn/
پس از	/pæs æz/
پس از این	/pæs æz iːn/
پس انداز	/pæsændɒːz/
پس انداز کردن	/pæsændɒːzkæɾdæn/
پست	/pæst/
پست	/post/
پست الکترونیکی	/poste elekteɾoniːkiː/
پستان	/pestɒːn/
پستان بند	/pestɒːn bænd/
پستاندار	/pestɒːndɒːɾ/
پستاندار	/pestɒːndæɾ/
پستچی	/postt͡ʃiː/
پستخانه	/postxɒːne/
پست سفارشی	/poste sefɒːɾʃiː/
پسته	/peste/
پست هوائی	/post hævɒːjiː/
پس دادن	/pæsdɒːdæn/
پسر	/pesæɾ/
پسر برادر	/pesæɾe bæɾɒːdæɾ/
پسرخاله	/pesæɾxɒːle/
پسرخوانده	/pesæɾxwɒːnde/
پسر خواهر	/pesæɾe xwɒːhæɾ/
پسردایی	/pesæɾdɒːjiː/
پسردائی	/pesæɾdɒːʔiː/
پسرعمه	/pesæɾʔæmme/
پسرعمه	/pesæɾæmme/
پسرعمو	/pesæɾʔæmuː/
پسرعمو	/pesæɾæmuː/
پس زدن	/pæszædæn/
پس‌زمینه	/pæszæmiːne/
پس غذا	/pæsɢæzɒː/
پس فردا	/pæs fæɾdɒː/
پس‌فردا	/pæsfæɾdɒː/
پس کشیدن	/pæskeʃiːdæn/
پسکوف	/pskuːf/
پس گردنی	/pæsɡæɾdæniː/
پس گردنی زدن	/pæsɡæɾdæniːzædæn/
پسگک	/pæsæɡæk/
پس‌لرزه	/pæslæɾze/
پسند	/pæsænd/
پسندیده	/pæsændiːdæ/, /pæsændiːde/
پسند کردن	/pæsændkæɾdæn/
پسوند	/pæsvænd/
پیش	/piːʃ/
پیشی	/piːʃiː/
پیشاب	/peʃɒːb/
پیش از ظهر	/piːʃ æz zohɾ/
پیش‌افکند	/piːʃæfkænd/
پیشانی	/piːʃɒːniː/
پیشاور	/peʃɒːvæɾ/
پیشباز / پیشواز	/piːʃbɒːz / piːʃvɒːz/
پیشباز / پیشواز آمدن	/piːʃbɒːzɒːmædæn/
پیش‌بینی	/piːʃbiːniː/
پیش‌بینی کردن	/piːʃbiːniːkæɾdæn/
پیش‌بینی‌ کردن	/piːʃbiːniː kæɾdæn/
پشت	/poʃt/
پشتیبان	/poʃtiːbɒːn/
پشتیبانی	/poʃtiːbɒːniː/
پشتیبانی کردن	/poʃtiːbɒːniːkæɾdæn/
پشت پا	/poʃte pɒː/
پشت پا زدن	/poʃtepɒːzædæn/
پشت سر هم	/poʃte sæɾe hæm/
پشتک	/pæʃtæk/
پشتک	/poʃtæk/
پشتک زدن	/poʃtækzædæn/
پشت گردنی	/poʃt ɡæɾdæniː/
پشت گردنی زدن	/poʃtɡæɾdæniːzædæn/
پشتو	/pæʃto/
پیشرفت	/piːʃɾæft/
پیشرفت کردن	/piːʃɾæftkæɾdæn/
پیشرفته	/piːʃɾæfte/
پیشکش	/piːʃkeʃ/, /piːʃkæʃ/
پیش میاد دیگه	/píʃ miːɒːd diːɡe/
پیشین	/piːʃiːn/
پیشنام	/piːʃnɒːm/
پیشنهاد	/peʃnæhɒːd/
پیشنهاد	/piːʃnæhɒːd/
پیشنهاد دادن	/piːʃnæhɒːddɒːdæn/
پیشنهاد کردن	/peʃnæhɒːd kæɾdæn/
پیشنهاد کردن	/piːʃnæhɒːdkæɾdæn/
پشه	/pæʃe/
پیشه	/piːʃæ/
پیشه	/piːʃe/
پشه بند	/pæʃebænd/
پشه بند زدن	/pæʃebændzædæn/
پشه زدن	/pæʃezædæn/
پیشوند	/piːʃvænd/
پیغام	/pejɢɒːm/
پی‌غذا	/t͡ʃiːɢæzɒː/
پف فیل	/pofefiːl/
پیک	/pejk/
پک	/pok/
پک زدن	/pokzædæn/
پکن	/pekæn/
پیل	/piːl/
پل	/pol/
پلاتین	/pelɒːtiːn/
پلاتو	/pelæto/
پلاتو زدن	/pelætozædæn/
پلاسما	/plɒːsmɒː/
پلاک	/pelɒːk/
پلاک زدن	/pelɒːkzædæn/
پلانک	/plɒːnk/
پل زدن	/polzædæn/
پلیس	/poliːs/
پلک	/pælk/
پلک	/pelk/
پلک زدن	/pelkzædæn/
پل کشیدن	/polkeʃiːdæn/
پلیمر	/poliːmeɾ/
پلنگ	/pælænɡ/
پلنگ برفی	/pælænɡe bæɾfiː/
پله	/pelle/
پله برقی	/pele bæɾɢiː/
پلو	/polo/
پماد	/pomɒːd/
پماد زدن	/pomɒːdzædæn/
پیمان	/pejmɒːn/
پیمانه	/pejmɒːnæ/
پیمانه	/pejmɒːne/
پیمانه کردن	/pejmɒːnekæɾdæn/
پمپ	/pomp/
پمپ بنزین	/pompe benziːn/
پنالتی	/penɒːltiː/
پنالتی زدن	/penɒːltiːzædæn/
پناه	/pænɒːh/
پناه آوردن	/pænɒːhɒːvæɾdæn/
پناه بردن	/pænɒːhboɾdæn/
پناه دادن	/pænɒːhdɒːdæn/
پنج	/pænd͡ʒ/
پنجابی	/pænd͡ʒɒːbiː/
پنجاه	/pænd͡ʒɒːh/
پنجر	/pænd͡ʒeɾ/, /pænd͡ʒæɾ/
پنجره	/pænd͡ʒeɾe/, /pænd͡ʒæɾe/
پنجشنبه	/pænd͡ʒʃænbe/
پنج‌شنبه	/pænd͡ʒʃænbe/
پنجم	/pænd͡ʒom/
پنجه	/pænd͡ʒe/
پنجه زدن	/pænd͡ʒezædæn/
پنجول	/pænd͡ʒuːl/
پنجول زدن	/pænd͡ʒuːlzædæn/
پنجول کشیدن	/pænd͡ʒuːlkeʃiːdæn/
پند	/pænd/
پندار	/pendɒːɾ/
پنیر	/pæniːɾ/
پنسیلین	/penesiːliːn/
پنیسیلین	/peniːsiːliːn/
پنسیلین زدن	/penesiːliːnzædæn/
پنکه	/pænke/
پنگان	/penɡɒːn/
پنگوئن	/pænɡuːæn/
پین‌یین	/piːnjiːn/
پینه	/piːne/
پنهان	/penhɒːn/
پنهانی	/penhɒːniː/
پنهان کردن	/penhɒːn kæɾdæn/
پینه بستن	/piːnebæstæn/
پینه زدن	/piːnezædæn/
پهپاد	/pæhpɒːd/
پهلو	/pæhluː/
پهن	/pæhn/
پهن	/pehen/
پهنیان	/pehenjɒːn/
پوپک	/puːpæk/
پوتین	/puːtiːn/
پوچ	/puːt͡ʃ/
پودینگ	/puːdiːnɡ/
پور	/puːɾ/
پورتال	/poɾtɒːl/
پورسلین	/poɾseliːn/
پور سینا	/puːɾe siːnɒː/
پورنوگرافی	/poɾnoɡɾɒːfiː/
پوزیترون	/posiːtɾon/
پوزخند	/puːzxænd/
پوزخند زدن	/puːzxændzædæn/
پوزه	/puːze/
پوزه زدن	/puːzezædæn/
پوزه کشیدن	/puːzekeʃiːdæn/
پوست	/puːst/
پوست بیضه	/puːste bejze/
پوست درخت	/puːste deɾæxt/
پوستر	/posteɾ/
پوست کندن	/puːst kændæn/
پوست گرفتن	/puːstɡeɾeftæn/
پیوستن	/pejvæstæn/
پیوسته	/pejvæstæ/, /pejvæste/
پوسته	/puːstæ/, /puːste/
پوسده	/puːsedæh/
پوشیدن	/puːʃiːdæn/
پوشیده	/puːʃiːdæ/
پوشه	/puːʃe/
پوکر	/puːkeɾ/, /pokeɾ/
پول	/puːl/
پولاد	/puːlɒːd/
پوما	/puːmɒː/
پیوند	/pejvænd/
پیوند زدن	/pejvændzædæn/
پونز	/puːnez/
پیونگ‌یانگ	/piːjonɡjɒːnɡ/
پونه	/puːne/
پي ريزي	/pejɾiːziː/
پيش بايست	/piːʃ bɒːjæst/
پيش شرط	/piːʃ ʃæɾt/
تا	/tɒː/
تا اين اندازه	/tɒː iːn ændɒːzæ/, /tɒː iːn ændɒːze/
تاب	/tɒːb/
تابستان	/tɒːbestɒːn/
تابع	/tɒːbeʔ/
تابع گاما	/tɒːbee ɡæmmæ/
تابلوی اعلانات	/tɒːbloje eʔlɒːnɒːt/
تابناک	/tɒːbnɒːk/
تابه	/tɒːbe/
تابوت	/tɒːbuːt/
تایپه	/tɒːjpe/
تاتار	/tɒːtɒːɾ/
تاتارستان	/tætæɾstɒːn/
تایتانیک	/tejtɒːniːk/
تاج	/tɒːd͡ʒ/
تاجیک	/tɒːd͡ʒiːk/
تاجیکی	/tɒːd͡ʒiːkiː/
تاجیکستان	/tɒːd͡ʒiːkestɒːn/
تاج‌محل	/tɒːd͡ʒmæhæl/
تایید	/tæʔiːd/
تایید شدن	/tæʔiːdʃodæn/
تایید کردن	/tæʔiːdkæɾdæn/
تاراج	/tɒːɾɒːd͡ʒ/
تاراج کردن	/tɒːɾɒːd͡ʒkæɾdæn/
تارتنک	/tɒːɾtænæk/
تاریخ	/tɒːɾiːx/
تاریخ	/tɒːɾîx/
تاریک	/tɒːɾiːk/
تاریکی	/tɒːɾiːkiː/
تارنما	/tɒːɾnæmɒː/
تازی	/tɒːziː/
تازیانه	/tɒːziːjɒːne/
تازیانه	/tɒːziːɒːne/
تازیانه زدن	/tɒːziːɒːnezædæn/
تازیانه‌ها	/tɒːziːjɒːnehɒː/
تازه	/tɒːze/
تازه‌ها	/tɒːzehɒː/
تاسیس	/tæʔsiːs/
تاسیس کردن	/tæʔsiːskæɾdæn/
تاسمانی	/tɒːsmɒːniː/
تا شدن	/tɒːʃodæn/
تاشکند	/tɒːʃkænd/
تاکتیک	/tɒːktiːk/
تاکید	/tæʔkiːd/
تاکید کردن	/tæʔkiːdkæɾdæn/
تا کردن	/tɒː kæɾdæn/
تا کردن	/tɒːkæɾdæn/
تاکسی	/tɒːksiː/
تایلندی	/tɒːjlændiː/
تایلند	/tɒːjlɒːnd/
تامبوف	/tɒːmbuːf/
تاميل	/tɒːmiːl/
تاندون	/tɒːndon/
تانزانیا	/tɒːnzɒːniːjɒː/
تانک	/tɒːnk/
تایوان	/tɒːiːvɒːn/
تاول	/tɒːvæl/
تاول زدن	/tɒːvælzædæn/
تب	/tæb/
تبار	/tæbɒːɾ/
تباری	/tæbɒːɾiː/
تباه	/tæbɒːh/
تبت	/tebbet/, /tæbbæt/
تبخال	/tæbxɒːl/
تبخال زدن	/tæbxɒːlzædæn/
تبدیل	/tæbdiːl/
تبدیل کردن	/tæbdiːlkæɾdæn/
تبر	/tæbæɾ/
تبریز	/tæbɾiːz/
تبر زدن	/tæbæɾzædæn/
تبریک	/tæbɾiːk/
تبریک گفتن	/tæbɾiːkɡoftæn/
تبرئه	/tæbɾæʔe/
تبرئه کردن	/tæbɾæʔekæɾdæn/
تبسم	/tæbæssom/
تبسم کردن	/tæbæssomkæɾdæn/
تب کردن	/tæbkæɾdæn/
تبیلیسی	/tiːbiːliːsiː/
تبلیغ	/tæbliːɢ/
تبلیغات	/tæbliːɢɒːt/
تیپا	/tiːpɒː/
تیپا زدن	/tiːpɒːzædæn/
تپق	/topoɢ/
تپق زدن	/topoɢzædæn/
تپه	/tæpe/
تیتر	/tiːtɾ/
تتراهیدروکانابینول	/tetɾɒːhiːdɾokɒːnɒːbiːnol/
تیتر زدن	/tiːtɾzædæn/
تثبیت	/tæsbiːt/
تثبیت کردن	/tæsbiːtkæɾdæn/
تجاری	/ted͡ʒɒːɾiː/
تجارت	/ted͡ʒɒːɾæt/
تجارتخانه	/ted͡ʒɒːɾætxɒːnæ/, /ted͡ʒɒːɾætxɒːne/
تجاوز	/tæd͡ʒɒːvoz/
تجاوز جنسی	/tæd͡ʒɒːvoz d͡ʒensiː/
تجدیدنظر	/tæd͡ʒdiːde næzæɾ/
تجدیدنظر کردن	/tæd͡ʒdiːdenæzæɾkæɾdæn/
تجدید نظر کردن	/tæd͡ʒdiːde næzæɾ kæɾdæn/
تجربه	/tæd͡ʒɾobe/
تجربه کردن	/tæd͡ʒɾobekæɾdæn/
تجنیس	/tæd͡ʒniːs/
تجویز	/tæd͡ʒviːz/
تجویز کردن	/tæd͡ʒviːzkæɾdæn/
تحریك	/tæhɾiːk/
تحریك کردن	/tæhɾiːkkæɾdæn/
تحریم‌	/tæhɾiːm/
تحریم	/tæhɾiːm/
تحریم‌ کردن	/tæhɾiːmkæɾdæn/
تحسین	/tæhsiːn/
تحقق	/tæhæɢɢoɢ/
تحقق یافتن	/tæhæɢɢoɢjɒːftæn/
تحمل	/tæhæmmol/
تحمیل	/tæhmiːl/
تحمل کردن	/tæhæmmolkæɾdæn/
تحمیل کردن	/tæhmiːlkæɾdæn/
تحول	/tæhævvol/
تحویل	/tæhviːl/
تحویل دادن	/tæhviːldɒːdæn/
تحویل گرفتن	/tæhviːlɡeɾeftæn/
تخت	/tæxt/
تخت جمشید	/tæxted͡ʒæmʃiːd/
تخت طاووس	/tæxte tɒːvuːs/
تخته	/tæxte/
تخته‌پاک‌کن	/tæxtepɒːkkon/
تخته زدن	/tæxtezædæn/
تخته سیاه	/tæxteje siːjɒːh/
تخته سنگ	/tæxtæsænɡ/, /tæxtesænɡ/
تخته نرد	/tæxtenæɾd/
تخته نرد زدن	/tæxtenæɾdzædæn/
تخفیف	/tæxfiːf/
تخفیف دادن	/tæxfiːfdɒːdæn/
تخم	/toxm/
تخم‌دان	/toxmdɒːn/
تخم کردن	/toxmkæɾdæn/
تخم مرغ	/toxme moɾɢ/
تخم مرغ	/toxmemoɾɢ/
تخمین	/tæxmiːn/
تخمین زدن	/tæxmiːnzædæn/
تخمین کردن	/tæxmiːnkæɾdæn/
تخمه	/toxmæ/
تدوینگر	/tædviːnɡæɾ/
تذکر	/tæzækkoɾ/
تذکر دادن	/tæzækkoɾdɒːdæn/
تیر	/tiːɾ/
تیر	/tîɾ/
ترا	/toɾɒː/
ترابار كردن	/tæɾɒːbɒːɾ/
ترازو	/tæɾɒːzuː/
تراش	/tæɾɒːʃ/
تراموای	/tɾɒːmvɒːj/
تیرانداز	/tiːɾændɒːz/
ترانسیلوانیا	/teɾɒːnsiːlvɒːniːjɒː/
ترانه	/tæɾɒːne/
تراوش	/tæɾɒːvoʃ/
تراوش کردن	/tæɾɒːvoʃkæɾdæn/
ترب	/toɾob/
ترجیح	/tæɾd͡ʒiːh/
ترجیح دادن	/tæɾd͡ʒiːh dɒːdæn/
ترجیح دادن	/tæɾd͡ʒiːhdɒːdæn/
ترجمان	/tæɾd͡ʒomɒːn/
ترجمه	/tæɾd͡ʒome/
ترجمه کردن	/tæɾd͡ʒome kæɾdæn/
ترجمه کردن	/tæɾd͡ʒomekæɾdæn/
ترجمه ماشینی	/tæɾd͡ʒome mɒːʃiːniː/
ترخانه	/tæɾxɒːnæ/
تردستی	/tæɾdæstiː/
تیر زدن	/tiːɾzædæn/
ترس	/tæɾs/
ترسا	/tæɾsɒː/
ترسایی	/tæɾsɒːjiː/
ترساندن	/tæɾsɒːndæn/
ترسیدن	/tæɾsiːdæn/
ترسناک	/tæɾsnɒːk/
ترسو	/tæɾsuː/
ترش	/toɾʃ/
ترشی	/toɾʃiː/
ترشیده	/toɾʃiːdæh/
ترغیب	/tæɾɢiːb/
ترغیب کردن	/tæɾɢiːbkæɾdæn/
ترفند	/tæɾfænd/
ترفند زدن	/tæɾfændzædæn/
ترک	/tæɾæk/
ترک	/tæɾk/
ترک	/toɾk/
ترکی	/toɾkiː/
ترک برداشتن	/tæɾækbæɾdɒːʃtæn/
ترک زدن	/tæɾækzædæn/
ترکستان	/toɾkestɒːn/
تیر کشیدن	/tiːɾkeʃiːdæn/
ترکی عثمانی	/toɾkiːje ʔosmɒːniː/
ترک کردن	/tæɾæk kæɾdæn/
ترک کردن	/tæɾkkæɾdæn/
ترکمنستان	/toɾkæmænestɒːn/
ترکیه	/toɾkiːje/
ترکیه‏ای	/toɾkiːjeʔiː/
ترگمان	/tæɾɡomɒːn/
ترمتای	/tæɾmætɒːj/
ترمذ	/teɾmez/
ترمز	/toɾmoz/
ترمز کردن	/toɾmozkæɾdæn/
ترنج	/toɾænd͡ʒ/
ترنسنیستریا	/tɾænsniːstɾiːjɒː/
تره	/tæɾe/
ترویج	/tæɾviːd͡ʒ/
ترویج کردن	/tæɾviːd͡ʒkæɾdæn/
تروریست	/teɾoɾiːst/
تروریسم	/teɾuːɾiːsm/
تیر و کمان	/tiːɾokæmɒːn/
ترول	/tɾuːl/
تیز	/tiːz/
تیزآب	/tiːzɒːb/
تیزآب سلطانی	/tiːzɒːbe soltæniː/
تزار	/tzɒːɾ/
تزیین	/tæzʔiːn/
تزیین کردن	/tæzʔiːnkæɾdæn/
تسار	/tsɒːɾ/
تسبیح	/tæsbiːh/
تسکین	/tæskiːn/
تسکین دادن	/tæskiːndɒːdæn/
تسلط	/tæsællot/
تسلط داشتن	/tæsællotdɒːʃtæn/
تسلط داشتن	/tæsælot dɒːʃtæn/
تسلیم	/tæsliːm/
تسلیم شدن	/tæsliːmʃodæn/
تسلیم کردن	/tæsliːmkæɾdæn/
تشبیه	/tæʃbiːh/
تشبیه کردن	/tæʃbiːhkæɾdæn/
تشخیص	/tæʃxiːs/
تشخیص دادن	/tæʃxiːsdɒːdæn/
تشدید	/tæʃdiːd/
تشدید کردن	/tæʃdiːdkæɾdæn/
تشر	/tæʃæɾ/
تشر زدن	/tæʃæɾzædæn/
تشریف	/tæʃɾiːf/
تشریف آوردن	/tæʃɾiːfɒːvæɾdæn/
تشریف بردن	/tæʃɾiːfboɾdæn/
تشکر	/tæʃækkoɾ/
تشکر	/tæʃækoɾ/
تشکر کردن	/tæʃækkoɾkæɾdæn/
تشکیل	/tæʃkiːl/
تشکیل دادن	/tæʃkiːldɒːdæn/
تشکیل شدن	/tæʃkiːlʃodæn/
تشنه	/teʃne/
تشویق	/tæʃviːɢ/
تشویق کردن	/tæʃviːɢkæɾdæn/
تشويق	/tæʃviːɢ/
تشويق شدن	/tæʃviːɢʃodæn/
تشويق کردن	/tæʃviːɢkæɾdæn/
تصاحب	/tæsɒːhob/
تصاحب کردن	/tæsɒːhobkæɾdæn/
تصادفی	/tæsɒːdofiː/
تصدیق	/tæsdiːɢ/
تصدیق کردن	/tæsdiːɢkæɾdæn/
تصرف	/tæsæɾɾof/
تصرف کردن	/tæsæɾɾofkæɾdæn/
تصمیم گرفتن	/tæsmiːm ɡeɾeftæn/
تصنيف هجائی	/tæsniːfe hed͡ʒɒːʔiː/
تصویب	/tæsviːb/
تصویب رسیدن	/tæsviːbɾesiːdæn/
تصویب کردن	/tæsviːbkæɾdæn/
تصور	/tæsævvoɾ/
تصویر	/tæsviːɾ/
تصور کردن	/tæsævvoɾkæɾdæn/
تضاد	/tæzzɒːd/
تطبیق	/tætbiːɢ/
تطبیق دادن	/tætbiːɢdɒːdæn/
تطبیق کردن	/tætbiːɢkæɾdæn/
تعارف	/tæʔɒːɾof/
تعارف کردن	/tæʔɒːɾofkæɾdæn/
تعجب	/tæʔæd͡ʒd͡ʒob/
تعجب ساختن	/tæʔæd͡ʒob sɒːxtæn/
تعجب کردن	/tæʔæd͡ʒd͡ʒobkæɾdæn/
تعریف	/tæʔɾiːf/
تعریف کردن	/tæʔɾiːf kæɾdæn/
تعریف کردن	/tæʔɾiːfkæɾdæn/
تعظیم	/tæʔziːm/
تعظیم کردن	/tæʔziːmkæɾdæn/
تعقیب	/tæʔɢiːb/
تعقیب کردن	/tæʔɢiːbkæɾdæn/
تعلق	/tæʔælloɢ/
تعلق داشتن	/tæʔælloɢdɒːʃtæn/
تعلق گرفتن	/tæʔælloɢɡeɾeftæn/
تعلم	/tæʔællom/
تعلیم	/tæʔliːm/
تعمیر	/tæʔmiːɾ/
تعمیرکار	/tæʔmiːɾkɒːɾ/
تعمیر کردن	/tæʔmiːɾ kæɾdæn/
تعیین	/tæʔiːn/
تعیین کردن	/tæʔiːnkæɾdæn/
تیغ	/tiːɢ/
تیغ اوکام	/tiːɢ okɒːm/
تغییر	/tæɢʔiːɾ / tæɢjiːɾ/
تغییر	/tæɢjiːɾ/
تغییرعقیده	/tæɢʔiːɾe æɢiːde/
تغییرعقیده دادن	/tæɢʔiːɾeæɢiːdedɒːdæn/
تغییر کردن	/tæɢʔiːɾkæɾdæn/
تغییرمسیر	/tæɢjiːɾemæsiːɾ/
تیغ زدن	/tiːɢzædæn/
تف	/tof/
تفریح	/tæfɾiːh/
تف کردن	/tofkæɾdæn/
تفلیس	/tiːfliːs/
تفنگ	/tofænɡ/
تقدیر	/tæɢdiːɾ/
تقریب	/tæɢɾiːb/
تقریبا	/tæɢɾiːbæn/
تقریب زدن	/tæɢɾiːbzædæn/
تقلا	/tæɢællɒː/
تقلا کردن	/tæɢællɒːkæɾdæn/
تقلید	/tæɢliːd/
تقلید کردن	/tæɢliːd kæɾdæn/
تقلید کردن	/tæɢliːdkæɾdæn/
تقویت	/tæɢviːæt/
تقویت شدن	/tæɢviːætʃodæn/
تقویت کردن	/tæɢviːætkæɾdæn/
تقویت نمودن	/tæɢviːætnemuːdæn/
تقویم	/tæɢviːm/
تكرار	/tekɾɒːɾ/
تكرار کردن	/tekɾɒːɾkæɾdæn/
تكواژ	/tækvɒːʒ/
تک	/tæk/
تکان	/tekɒːn/
تکان خوردن	/tekɒːnxoɾdæn/
تکاوری	/tækɒːvæɾiː/
تک‌تیرانداز	/tæktiːɾændɒːz/
تکرار	/tækɾɒːɾ/
تکرار	/tekɾɒːɾ/
تکرار شدن	/tækɾɒːɾ ʃodæn/
تکرار شدن	/tekɾɒːɾʃodæn/
تکرار کردن	/tekɾɒːɾkæɾdæn/
تکمه	/tokmæ/, /tokme/
تکمه	/tokme/
تکنیک	/tekniːk/
تکنولوژی	/teknoloʒiː/
تکیه	/tækje/
تکیه	/tækje / tekje/
تکه	/tekke/
تکیه دادن	/tækjedɒːdæn/
تکیه زدن	/tækjezædæn/
تگرگ	/tæɡæɾɡ/
تگزاس	/teɡzɒːs/
تگزاسی	/teɡzɒːsiː/
تلاش	/tælɒːʃ/
تلاش بودن	/tælɒːʃbuːdæn/
تلاش کردن	/tælɒːʃkæɾdæn/
تلافی	/tælɒːfiː/
تلافی کردن	/tælɒːfiːkæɾdæn/
تلخ	/tælx/
تلسکوپ	/teleskop/
تلف	/tælæf/
تلفظ	/tælæffoz/
تلفظ کردن	/tælæffoz kæɾdæn/
تلف کردن	/tælæfkæɾdæn/
تلفن	/telefon/
تلفن زدن	/telefon zædæn/
تلفن زدن	/telefonzædæn/
تلفن کردن	/telefon kæɾdæn/
تلفن کردن	/telefonkæɾdæn/
تلفن موبایل	/telefone mobɒːjl/
تلفن همراه	/telefone hæmɾɒːh/
تلفن هوشمند	/telefone huːʃmænd/
تلگراف	/teleɡɾɒːf/
تلگراف زدن	/teleɡɾɒːfzædæn/
تلگراف شدن	/teleɡɾɒːfʃodæn/
تلگراف کردن	/teleɡɾɒːfkæɾdæn/
تلمبه	/tolombe/
تلمبه زدن	/tolombezædæn/
تلنگر	/tælænɡoɾ/
تلنگر زدن	/tælænɡoɾzædæn/
تیله	/tiːle/
تلویزیون	/televiːziːon/
تلویزیون کابلی	/televiːziːon kɒːbliː/
یتیم	/jætiːm/
تیم	/tiːm/
تماس	/tæmɒːs/
تماس گرفتن	/tæmɒːs ɡeɾeftæn/
تماس گرفتن	/tæmɒːsɡeɾeftæn/
تماشا	/tæmɒːʃɒː/
تماشا‌کردن	/tæmɒːʃækæɾdæn/
تماشا کردن	/tæmɒːʃɒː kæɾdæn/
تماشا کردن	/tæmɒːʃɒːkæɾdæn/
تمام	/tæmɒːm/
تمام‌خط	/tæmɒːmxæt/
تمام شدن	/tæmɒːm ʃodæn/
تمام کردن	/tæmɒːm kæɾdæn/
تمبر	/tæmɾ/
تمبر	/tæmbɾ/
تمبر پستی	/tæmbɾe postiː/
تمبر زدن	/tæmɾzædæn/
تمبک	/tombæk/
یتیم‌خانه	/jætiːmxɒːne/
تمرین	/tæmɾiːn/
تمرین کردن	/tæmɾiːn kæɾdæn/
تمیز	/tæmiːz/
تمیز کردن	/tæmiːz kæɾdæn/
تمساح	/temsɒːh/
تمشک	/tæmeʃk/
تمنا	/tæmænnɒː/
تمنا کردن	/tæmænnɒːkæɾdæn/
تن	/tæn/
تنی	/tæniː/
تن	/ton/
تنباکو	/tæbɒːko/
تنبل	/tænbæl/
تند	/tond/
تن دادن	/tændɒːdæn/
تن داشتن	/tændɒːʃtæn/
تندپز	/tondpæz/
تندر	/tondæɾ/
تندرست	/tændæɾæst/
تندرست	/tændoɾost/
تنیس	/teniːs/
تنیس زدن	/teniːszædæn/
تن‌فروشی	/tænfoɾuːʃiː/
تن کردن	/tænkæɾdæn/
تنگ	/tænɡ/
تنگدستی	/tænɡdæstiː/
تنگستن	/tænɡesten/
تنگنا	/tænɡnɒː/
تنگی نفس	/tænɡiːe næfæs/
تنگه بسفر	/tænɡæ bosfoɾ/
تنگه هرمز	/tænɡeje hoɾmoz/
تنندگان	/tænændeɡɒːn/
تنه	/tæne/
تنها	/tænhɒː/
تنهایی	/tænhɒːjiː/
تنه زدن	/tænezædæn/
تنور	/tænuːɾ/
تهی	/tohiː/
ته تغاری	/tætoɢɒːɾiː/
تهدید	/tæhdiːd/
تهدید کردن	/tæhdiːdkæɾdæn/
تهران	/tehɾɒːn/
تهرانی	/tehɾɒːniː/
تهرون	/tehɾuːn/
تهمت	/tohmæt/
تهمت زدن	/tohmætzædæn/
تیهو	/tiːhuː/
تهيه	/tæhiːje/
تهيه دیدن	/tæhiːjediːdæn/
تهيه کردن	/tæhiːjekæɾdæn/
تو	/to/
تو	/tuː/
توازن قدرت	/tævɒːzone ɢodɾæt/
توافق	/tævɒːfoɢ/
توافق رسیدن	/tævɒːfoɢɾesiːdæn/
توالت	/tuːɒːlet/
توان	/tævɒːn/
‏توانا بود هر که دانا بود	/tævɒːnɒː bovæd hæɾ ke dɒːnɒː bovæd/
توان بویایی	/tævɒːne buːjɒːjiː/
توانستن	/tævɒːnestæn/
توبه	/toʊbe/
توبه کردن	/toʊbekæɾdæn/
توپ	/tuːp/
توپ وتشر	/tuːp o tæʃæɾ/
توپ وتشر زدن	/tuːpotæʃæɾzædæn/
توت	/tuːt/
توت فرنگی	/tuːt fæɾænɡiː/
توت‌فرنگی	/tuːtfæɾænɡiː/
توجه	/tævæd͡ʒd͡ʒoh/
توجیه	/tod͡ʒiːh/
توجه شدن	/tævæd͡ʒd͡ʒohʃodæn/
توجه کردن	/tævæd͡ʒd͡ʒohkæɾdæn/
توجیه کردن	/tod͡ʒiːhkæɾdæn/
توحید	/touːhiːd/
تودار	/tuːdɒːɾ/
تودهنی	/tuːdæhæniː/
تودهنی زدن	/tuːdæhæniːzædæn/
تو را	/tuːɾɒː/
تورات	/tuːɾɒːt/, /tævɾɒːt/
تو راه	/tuː ɾɒːh/
تورم	/tævæɾɾom/
توزیع	/toziːæ/
توزلا	/tuːzlɒː/
توسری	/tuːsæɾiː/
توسری زدن	/tuːsæɾiːzædæn/
توصیف	/toʊsiːf/
توصیف کردن	/toʊsiːfkæɾdæn/
توضیح	/toʊziːh/
توضیح دادن	/tæwziːh dɒːdæn/
توضیح دادن	/toʊziːhdɒːdæn/
توفا	/tuːfɒː/
توقع	/tævæɢɢoʔ/
توقع داشتن	/tævæɢɢoʔdɒːʃæn/
توکان	/tuːkɒːn/
توگوشی	/tuːɡuːʃiː/
توگوشی زدن	/tuːɡuːʃiːzædæn/
تولد	/tævællod/
تولد	/tævælod/
تولید	/touːliːd/
تولدت مبارک	/tævɒːllodæt mobɒːɾæk/
توله	/tuːle/
توله سگ	/tuːle sæɡ/
تومسک	/tomsk/
توندرا	/tuːndɾɒː/
تونس	/tuːnes/
تونل	/tuːnel/
تونل زدن	/tuːnelzædæn/
تونل کشیدن	/tuːnelkeʃiːdæn/
توهین	/toʊhiːn/
توهین کردن	/toʊhiːnkæɾdæn/
تئاتر	/teʔɒːtɾ/
تئوری توطئه	/teʔoɾiːje touːteʔe/
ثابت	/sɒːbet/
ثابت پلانک	/sɒːbete plɒːnk/
ثانیه	/sɒːniːje/
ثبت	/sæbt/
ثبت کردن	/sæbtkæɾdæn/
ثریا	/ʃoɾæiːjɒː/
ثروت	/seɾvæt/
ثروتمند	/seɾvætmænd/
ثمر	/sæmæɾ/
ثمر داشتن	/sæmæɾdɒːʃtæn/
ثمر رسیدن	/sæmæɾɾesiːdæn/
جا	/d͡ʒɒː/
جای	/d͡ʒɒːj/
جا به جا	/d͡ʒɒː be d͡ʒɒː/
جا به جا شدن	/d͡ʒɒːbed͡ʒɒːʃodæn/
جا به جا کردن	/d͡ʒɒːbed͡ʒɒːkæɾdæn/
جاچسبی	/d͡ʒɒːt͡ʃæsbiː/
جادار	/d͡ʒɒːdɒːɾ/
جاده	/d͡ʒɒːdde/
جاده زدن	/d͡ʒɒːddezædæn/
جاده کشیدن	/d͡ʒɒːddekeʃiːdæn/
جادو	/d͡ʒɒːduː/
جادویی	/d͡ʒɒːduːjiː/
جادوی سیاه	/d͡ʒɒːduːje siːjɒːh/
جار	/d͡ʒɒːɾ/
جاری	/d͡ʒɒːɾiː/
جار زدن	/d͡ʒɒːɾzædæn/
جار کشیدن	/d͡ʒɒːɾkeʃiːdæn/
جارو	/d͡ʒɒːɾuː/
جاروب	/d͡ʒɒːɾuːb/
جارو برقی	/d͡ʒɒːɾuː bæɾɢiː/
جارو زدن	/d͡ʒɒːɾuːzædæn/
جارو کردن	/d͡ʒɒːɾuːkæɾdæn/
جارو کشیدن	/d͡ʒɒːɾuːkeʃiːdæn/
جاز	/d͡ʒɒːz/
جا زدن	/d͡ʒɒːzædæn/
جایزه	/d͡ʒɒːjeze/
جاسوس	/d͡ʒɒːsuːs/
جاسوسی	/d͡ʒɒːsuːsiː/
جاکارتا	/d͡ʒɒːkɒːɾtɒː/
جاکش	/d͡ʒɒːkeʃ/
جایگاه	/d͡ʒɒːjɡɒːh/
جا گرفتن	/d͡ʒɒːɡeɾeftæn/
جای‌گزین	/d͡ʒɒːjɡoziːn/
جالب	/d͡ʒɒːleb/
جا لباسي	/d͡ʒɒː lebɒːsiː/
جام	/d͡ʒɒːm/
جامدادی	/d͡ʒɒːmedɒːdiː/
جامع	/d͡ʒɒːmeʔ/
جامعه	/d͡ʒɒːmeʔe/
جان	/d͡ʒɒːn/
جانان	/d͡ʒɒːnɒːn/
جان دادن	/d͡ʒɒːndɒːdæn/
جان گرفتن	/d͡ʒɒːnɡeɾeftæn/
جانماز	/d͡ʒɒːnæmɒːz/
جانور	/d͡ʒɒːnvæɾ/
جانورشناسی	/d͡ʒɒːnvæɾʃenɒːsiː/
جاوی	/d͡ʒɒːviː/
جاوا	/d͡ʒɒːvɒː/
جاوه	/d͡ʒɒːve/
جیب	/d͡ʒejb/
جیب	/d͡ʒiːb/
جبر	/d͡ʒæbɾ/
جبری	/d͡ʒæbɾiː/
جبران	/d͡ʒobɾɒːn/
جبران شدن	/d͡ʒobɾɒːnʃodæn/
جبران کردن	/d͡ʒobɾɒːnkæɾdæn/
جبرییل	/d͡ʒebɾejiːl/
جبریل	/d͡ʒebɾiːl/
جبرئیل	/d͡ʒebɾæʔiːl/
جیب زدن	/d͡ʒiːbzædæn/
جیبوتی	/d͡ʒiːbuːtiː/
جیپ	/d͡ʒiːp/
جیحون	/d͡ʒejhuːn/
جدا	/d͡ʒeddæn/
جداچاپ	/d͡ʒodɒːt͡ʃɒːp/
جدال	/d͡ʒedɒːl/
جدال کردن	/d͡ʒedɒːlkæɾdæn/
جدید	/d͡ʒædiːd/
جده	/d͡ʒedde/
جدول تناوبی	/d͡ʒædvæle tænɒːvobiː/
جذام	/d͡ʒozɒːm/
جر	/d͡ʒeɾ/
جرأت	/d͡ʒoɾʔæt/
جرأت داشتن	/d͡ʒoɾʔætdɒːʃtæn/
جرأت کردن	/d͡ʒoɾʔætkæɾdæn/
جراحی	/d͡ʒæɾɾɒːhiː/
جراحی کردن	/d͡ʒæɾɾɒːhiːkæɾdæn/
جریب	/d͡ʒæɾiːb/
جیرجیرک	/d͡ʒiːɾd͡ʒiːɾæk/
جر زدن	/d͡ʒeɾzædæn/
جرقه	/d͡ʒæɾæɢɢe/
جرقه	/d͡ʒeɾæɢɢe/
جرقه زدن	/d͡ʒæɾæɢɢezædæn/
جرگه بزرگ	/d͡ʒæɾɡæ bozoɾɡ/
جرگه‌سالاری	/d͡ʒæɾɡesɒːlɒːɾiː/
جرگه‌سالاران	/d͡ʒæɾɡesɒːlɒːɾɒːn/
جرم	/d͡ʒeɾm/
جرم	/d͡ʒoɾm/
جرم گرفتن	/d͡ʒeɾmɡeɾeftæn/
جرمن شپرد	/d͡ʒæɾmæn ʃepæɾd/
جز	/d͡ʒoz/
جزء	/d͡ʒoz/
جزجز	/d͡ʒezd͡ʒez/
جزجز زدن	/d͡ʒezd͡ʒezzædæn/
جزجز کردن	/d͡ʒezd͡ʒezkæɾdæn/
جزر	/d͡ʒæzɾ/
جزیره	/d͡ʒæziːɾe/
جزیره ایستر	/d͡ʒæziːɾe iːsteɾ/
جزم	/d͡ʒæzm/
جست	/d͡ʒæst/
جستجو	/d͡ʒosted͡ʒuː/d͡ʒostod͡ʒuː/
جستجو کردن	/d͡ʒosted͡ʒuːkæɾdæn/
جستجو کردن	/d͡ʒostod͡ʒuː kæɾdæn/
جست زدن	/d͡ʒæstzædæn/
جستن	/d͡ʒostæn/
جسد	/d͡ʒæsæd/
جسم	/d͡ʒesm/
جیش	/d͡ʒiːʃ/
جشن	/d͡ʒɒːʃn/
جشن گرفتن	/d͡ʒɒːʃnɡeɾeftæn/
جشنواره	/d͡ʒæʃnvɒːɾe/
جعبه	/d͡ʒæʔbe/
جعبه نامه	/d͡ʒæʔbeje nɒːme/
جعفری	/d͡ʒæʔfæɾiː/
جعلی	/d͡ʒæʔliː/
جیغ	/d͡ʒiːɢ/
جیغ	/d͡ʒǐɢ/
جغد	/d͡ʒoɢd/
جغرافیا	/d͡ʒoɢɾɒːfiːjɒː/
جیغ زدن	/d͡ʒiːɢ zædæn/
جیغ زدن	/d͡ʒiːɢzædæn/
جیغ زدن	/d͡ʒǐɢ zædæn/
جیغ کشیدن	/d͡ʒiːɢkeʃiːdæn/
جفتک	/d͡ʒoftæk/
جفتک زدن	/d͡ʒoftækzædæn/
جیک	/d͡ʒiːk/
جیک زدن	/d͡ʒiːkzædæn/
جگر	/d͡ʒeɡæɾ/
جیگر	/d͡ʒiːɡæɾ/
جلا	/d͡ʒælɒː/
جلال‌آباد	/d͡ʒælɒːlɒːbɒːd/
جلد	/d͡ʒeld/
جلق	/d͡ʒælɢ/
جلق زدن	/d͡ʒælɢ zædæn/
جلیقه ی نجات	/d͡ʒeliːɢe je ned͡ʒɒːt/
جلو	/d͡ʒelo/
جلو	/d͡ʒeloʊ/
جلو	/d͡ʒelo/, /d͡ʒeloʊ /
جلو	/d͡ʒolo/
جلو زدن	/d͡ʒelozædæn/
جلو گرفتن	/d͡ʒeloʊɡeɾeftæn/
جیم	/d͡ʒiːm/
جمجمه	/d͡ʒomd͡ʒome/
جیمز	/d͡ʒejmz/
جمع	/d͡ʒæmʔ/
جمع زدن	/d͡ʒæmʔzædæn/
جمع کردن	/d͡ʒæmʔkæɾdæn/
جمعه	/d͡ʒomʔe/
جمله	/d͡ʒomle/
جمله‌شناسی	/d͡ʒomleʃenɒːsiː/
جمهوری	/d͡ʒomhuːɾiː/
جمهوری ارمنستان	/d͡ʒomhuːɾiːje æɾmænestɒːn/
جمهوری اسلامی ایران	/d͡ʒomhuːɾiːje eslɒːmiːje iːɾɒːn/
جمهوری ترکیه	/d͡ʒomhuːɾiːje toɾkiːje/
جمهوری چک	/d͡ʒomhuːɾiːje t͡ʃek/
جمهوری‌خواه	/d͡ʒomhuːɾiːxɒːh/
جمهوری عربی مصر	/d͡ʒomhuːɾiːje ʔæɾæbiːje mesɾ/
جن	/d͡ʒen/
جناب	/d͡ʒenɒːb/
جنازه	/d͡ʒænɒːze/, /d͡ʒenɒːze/
جناس	/d͡ʒenɒːs/
جنبش	/d͡ʒonbeʃ/
جنبش غیرمتعهد	/d͡ʒonbeʃe ædæme tæʔæhhod/
جنبش غیرمتعهد	/d͡ʒonbeʃe ɢejɾemoteʔæhhed/
جنت	/d͡ʒænnæt/
جنده	/d͡ʒende/
جنده‌خانه	/d͡ʒendexɒːne/
جنسی	/d͡ʒensiː/
جنسی	/d͡ʒínsiː/
جنس بلند کردن	/ɡens bolænd kæɾdæn/
جنسیت	/d͡ʒensiːjæt/
جنسیت‌گرایی	/d͡ʒensiːtɡæɾɒːjiː/
جنگ	/d͡ʒænɡ/
جنگ اسفلال طلبی	/d͡ʒænɡe esteɢlɒːl tælæbiː/
جنگ جهانی دوّم	/d͡ʒænɡe d͡ʒæhɒːniːe dovvom/
جنگ جهانی یكم	/d͡ʒænɡe d͡ʒæhɒːniːe jekom/
جنگ سرد	/d͡ʒænɡe sæɾd/
جنگل	/d͡ʒænɡæl/
جنگل زدن	/d͡ʒænɡælzædæn/
جنگ‌های صلیبی	/d͡ʒænɡhɒːje sæliːbiː/
جنوب	/d͡ʒonuːb/
جنوب شرقی	/d͡ʒonuːbe ʃæɾɢiː/
جنوب غربی	/d͡ʒonuːbe ɢæɾbiː/
جنوبگان	/d͡ʒuːnuːbeɡɒːn/
جهاد	/d͡ʒehɒːd/
جهاز	/d͡ʒæhɒːz/
جهالت	/d͡ʒ��hɒːlæt/
جهالت زدن	/d͡ʒæhɒːlætzædæn/
جهان	/d͡ʒæhɒːn/
جهانی‌سازی	/d͡ʒæhɒːniːsɒːziː/
جهان عرب	/d͡ʒæhɒːne ʔæɾæb/
جهت اطلاع	/d͡ʒæhæte ettelɒːʔ/
جهد	/d͡ʒæhd/
جهد کردن	/d͡ʒæhdkæɾdæn/
جهیدن	/d͡ʒæhiːdæn/
جهل	/d͡ʒæhl/
جهل زدن	/d͡ʒæhlzædæn/
جهنم	/d͡ʒæhænnæm/
جو	/d͡ʒævv/, /d͡ʒoʊ/, /d͡ʒuː/
جواب	/d͡ʒævɒːb/
جواب دادن	/d͡ʒævɒːb dɒːdæn/
جواب دادن	/d͡ʒævɒːbdɒːdæn/
جواب کردن	/d͡ʒævɒːbkæɾdæn/
جواب گرفتن	/d͡ʒævɒːbɡeɾeftæn/
جوان	/d͡ʒævɒːn/
جوانی	/d͡ʒævɒːniː/
جوانه	/d͡ʒævɒːne/
جوانه زدن	/d͡ʒævɒːnezædæn/
جوجه	/d͡ʒuːd͡ʒe/
جوجه‌تیغی	/d͡ʒuːd͡ʒetiːɢiː/
جویدن	/d͡ʒæviːdæn/
جوراب	/d͡ʒuːɾɒːb/
جورج	/d͡ʒoɾd͡ʒ/
جورجیا	/d͡ʒuːɾd͡ʒiːjɒː/
جورج تاون	/d͡ʒoɾd͡ʒ tɒːuːn/
جورج تائون	/d͡ʒoɾd͡ʒ tɒːʔuːn/
جوش	/d͡ʒuːʃ/
جوش آمدن	/d͡ʒuːʃɒːmædæn/
جوش آوردن	/d͡ʒuːʃɒːvæɾdæn/
جوش دادن	/d͡ʒuːʃdɒːdæn/
جوش زدن	/d͡ʒuːʃzædæn/
جولیا	/d͡ʒuːliːɒː/
جولان	/d͡ʒoʊlɒːn/
جولان دادن	/d͡ʒoʊlɒːndɒːdæn/
جیوه	/d͡ʒiːve/
جوهر	/d͡ʒoʊhæɾ/
جوهر شوره	/d͡ʒouːhæɾe ʃuːɾe/
جوهر نمک	/d͡ʒouːhæɾe næmæk/
چی	/t͡ʃiː/
چای	/t͡ʃɒːj/
چاباق‌سر	/t͡ʃɒːbɒːɢsæɾ/
چاپ	/t͡ʃɒːp/
چاپ زدن	/t͡ʃɒːpzædæn/
چاپ کردن	/t͡ʃɒːp kæɾdæn/
چاپ کردن	/t͡ʃɒːpkæɾdæn/
چادر	/t͡ʃɒːdoɾ/
چادر زدن	/t͡ʃɒːdoɾzædæn/
چادر شب	/t͡ʃɒːdæɾe ʃæb/
چارک	/t͡ʃɒːɾæk/
چارمیخ	/t͡ʃæhæɒːɾmiːx/
چارمیخ کشیدن	/t͡ʃæhæɒːɾmiːxkeʃiːdæn/
چاره	/t͡ʃɒːɾæ/, /t͡ʃɒːɾe/
چای سیاه	/t͡ʃɒːje siːjɒːh/
چای سبز	/t͡ʃɒːje sæbz/
چاشنی	/t͡ʃɒːʃniː/
چاقو	/t͡ʃɒːɢuː/
چاقو خوردن	/t͡ʃɒːɢuːxoɾdæn/
چاقو زدن	/t͡ʃɒːɢuːzædæn/
چاقوی سوئیسی	/t͡ʃɒːɢuːje suːiːsiː/
چاک	/t͡ʃɒːk/
چاک پستان	/t͡ʃɒːk pestɒːn/
چاک خوردن	/t͡ʃɒːkxoɾdæn/
چاک دادن	/t͡ʃɒːkdɒːdæn/
چاک زدن	/t͡ʃɒːkzædæn/
چال	/t͡ʃɒːl/
چال افتادن	/t͡ʃɒːloftɒːdæn/
چال انداختن	/t͡ʃɒːlændɒːxtæn/
چالش	/t͡ʃɒːleʃ/
چال کردن	/t͡ʃɒːlkæɾdæn/
چاله	/t͡ʃɒːle/
چامه	/t͡ʃɒːme/
چامه سرایی	/t͡ʃɒːme sæɾɒːjiː/
چانه	/t͡ʃɒːne/
چانه زدن	/t͡ʃɒːne zædæn/
چاه	/t͡ʃɒːh/
چاه زدن	/t͡ʃɒːhzædæn/
چبوق	/t͡ʃebuːɢ/
چپ	/t͡ʃæp/
چپاول	/t͡ʃæpɒːvol/
چپاول کردن	/t͡ʃæpɒːvolkæɾdæn/
چپق	/t͡ʃopoɢ/
چپق کشیدن	/t͡ʃopoɢkeʃiːdæn/
چپ‌گرا	/t͡ʃæpɡæɾɒː/
چتر	/t͡ʃætɾ/
چتر دریایی	/t͡ʃætɾ dæɾjɒːjiː/
چتر زدن	/t͡ʃætɾzædæn/
چچنی	/t͡ʃet͡ʃeniː/
چیدمان	/t͡ʃiːdemɒːn/
چیدن	/t͡ʃiːdæn/
چدن	/t͡ʃodæn/
چرا	/t͡ʃeɾɒː/
چراغ	/t͡ʃeɾɒːɢ/
چراغ	/t͡ʃeɾɒːĝ/
چراغ زدن	/t͡ʃeɾɒːɢzædæn/
چراغ مطالعه	/t͡ʃeɾɒːɢe motɒːleʔe/
چرا که نه	/t͡ʃeɾɒː ke nɒː/
چربی	/t͡ʃæɾbiː/
چرت	/t͡ʃoɾt/
چرت زدن	/t͡ʃoɾt zædæn/
چرت زدن	/t͡ʃoɾtzædæn/
چرتکه	/t͡ʃoɾtke/
چرخ	/t͡ʃæɾx/
چرخاندن	/t͡ʃæɾxɒːndæn/
چرخ خوردن	/t͡ʃæɾxxoɾdæn/
چرخیدن	/t͡ʃæɾxiːdæn/
چرخ زدن	/t��ʃæɾxzædæn/
چرک	/t͡ʃeɾk/
چرک	/t͡ʃoɾæk/
چرکس	/t͡ʃæɾkæs/
چرک گرفتن	/t͡ʃeɾkɡeɾeftæn/
چرم	/t͡ʃæɾm/
چرمی	/t͡ʃæɾmiː/
چرند	/t͡ʃæɾænd/
چرنده	/t͡ʃæɾænde/
چروک	/t͡ʃoɾuːk/
چروک خوردن	/t͡ʃoɾuːkxoɾdæn/
چیز	/t͡ʃiːz/
چیزی	/t͡ʃiːziː/
چیزبرگر	/t͡ʃiːzbeɾɡeɾ/
چسب	/t͡ʃæsb/
چسباندن	/t͡ʃæsbɒːndæn/
چسب زدن	/t͡ʃæsbzædæn/
چسب مایع	/t͡ʃæsbe mɒːjeʔ/
چسب نواری	/t͡ʃæsbe nævɒːɾiː/
چس فیل	/t͡ʃosefiːl/
چشیدن	/t͡ʃeʃiːdæn/
چشش	/t͡ʃeʃeʃ/
چشم	/t͡ʃæʃm/
چشم	/t͡ʃæŝm/
چشم	/t͡ʃeʃm/
چشم	/t͡ʃeʃm / t͡ʃæʃm/
چشم	/t͡ʃeʃm/, /t͡ʃæʃm/
چشم افتادن	/t͡ʃeʃmoftɒːdæn/
چشم آمدن	/t͡ʃeʃmɒːmædæn/
چشم انداختن	/t͡ʃeʃmændɒːxtæn/
چشم انداز	/t͡ʃæʃm ændɒːz/
چشم‌پزشک	/t͡ʃeʃmpezeʃk/
چشم‌پزشکی	/t͡ʃeʃmpezeʃkiː/
چشم خوردن	/t͡ʃeʃmxoɾdæn/
چشم زخم	/t͡ʃeʃmzæxm/
چشم زخم زدن	/t͡ʃeʃmzæxmzædæn/
چشم زدن	/t͡ʃeʃmzædæn/
چشم زهر	/t͡ʃeʃmzæhɾ/
چشم زهر گرفتن	/t͡ʃeʃmzæhɾɡeɾeftæn/
چشم‌غره	/t͡ʃeʃmɢoɾɾe/
چشم‌غره رفتن	/t͡ʃeʃmɢoɾɾeɾæftæn/
چشمک	/t͡ʃeʃmæk/
چشمک زدن	/t͡ʃeʃmækzædæn/
چشمه	/t͡ʃæʃmæ/
چطور	/t͡ʃetouːɾ/
چغندر	/t͡ʃoɢondæɾ/
چقدر	/t͡ʃeɢædɾ/
چک	/t͡ʃæk/
چک	/t͡ʃek/
چکی	/t͡ʃekiː/
چکاوک	/t͡ʃækɒːvæk/
چک خوردن	/t͡ʃækxoɾdæn/
چکرز	/t͡ʃekeɾz/
چک زدن	/t͡ʃækzædæn/
چکش	/t͡ʃækoʃ/
چکه	/t͡ʃekke/
چکه کردن	/t͡ʃekkekæɾdæn/
چکى	/t͡ʃekiː/
چگونه	/t͡ʃeɡuːne/
چلاقی	/t͡ʃolɒːɢiː/
چلاقی زدن	/t͡ʃolɒːɢiːzædæn/
چلیپا	/t͡ʃæliːpɒː/
چلچله	/t͡ʃelt͡ʃele/
چماق	/t͡ʃomɒːɢ/
چماق زدن	/t͡ʃomɒːɢzædæn/
چمباتمه	/t͡ʃombɒːtme/
چمباتمه زدن	/t͡ʃombɒːtmezædæn/
چمبر	/t͡ʃæmbæɾ/
چمبر زدن	/t͡ʃæmbæɾzædæn/
چمپداک	/t͡ʃæmpædɒːk/
چمچه	/t͡ʃæmt͡ʃe/, /t͡ʃomt͡ʃe/
چمدان	/t͡ʃæmedɒːn/
چین	/t͡ʃiːn/
چینی	/t͡ʃiːniː/
چین افتادن	/t͡ʃiːnoftɒːdæn/
چنبر	/t͡ʃænbæɾ/
چنبر زدن	/t͡ʃænbæɾzædæn/
چین تایپه	/t͡ʃiːn tɒːjpe/
چند	/t͡ʃænd/
چین دادن	/t͡ʃiːndɒːdæn/
چند تا	/t͡ʃænd tɒː/
چندتایی	/t͡ʃændtɒːjiː/
چندخدایی	/t͡ʃændxodɒːjiː/
چندش	/t͡ʃendeʃ/
چندش شدن	/t͡ʃendeʃʃodæn/
چندک	/t͡ʃondæk/
چندک زدن	/t͡ʃondækzædæn/
چندگانه	/t͡ʃændɡɒːne/
چندن	/t͡ʃændæn/
چندین	/t͡ʃændiːn/
چینی ساده‌شده	/t͡ʃiːniːje sɒːdeʃode/
چینی سنتی	/t͡ʃiːniːje sonætiː/
چنگ	/t͡ʃænɡ/
چنگال	/t͡ʃænɡɒːl/
چنگ آوردن	/t͡ʃænɡɒːvæɾdæn/
چنگ زدن	/t͡ʃænɡzædæn/
چنگك	/t͡ʃænɡæk/
چنین	/t͡ʃoniːn/
چه	/t͡ʃe/
چهار	/t͡ʃæhɒːɾ/
چهارده	/t͡ʃæhɒːɾdæh/
چهارشنبه	/t͡ʃæhɒːɾʃænbe/
چهارصد	/t͡ʃæhɒːɾsæd/
چهار گوش	/t͡ʃæhɒːɾɡuːʃ/
چهارم	/t͡ʃæhɒːɾom/
چهچهه	/t͡ʃæht͡ʃæhe/
چهچهه زدن	/t͡ʃæht͡ʃæhezædæn/
چهچهه کردن	/t͡ʃæht͡ʃæhekæɾdæn/
چهره	/t͡ʃehɾæ/
چهره	/t͡ʃehɾæ/, /t͡ʃehɾe/
چهره	/t͡ʃehɾe/
چهل	/t͡ʃehel/
چهل و پنج	/t͡ʃehelo pænd͡ʒ/
چوب	/t͡ʃuːb/
چوبی	/t͡ʃuːbiː/
چوبان	/t͡ʃuːbɒːn/
چوب خوردن	/t͡ʃuːbxoɾdæn/
چوب زدن	/t͡ʃuːbzædæn/
چوبین	/t͡ʃuːbiːn/
چوبه دار	/t͡ʃuːbæ je dɒːɾ/
چوپان	/t͡ʃuːpɒːn/
چوپون	/t͡ʃuːpuːn/
چوچوله	/t͡ʃuːt͡ʃuːlæ/, /t͡ʃuːt͡ʃuːle/
چوچوله	/t͡ʃuːt͡ʃuːle/
چورک	/t͡ʃuːɾæk/
چوگان	/t͡ʃoʊɡɒːn/
چون	/t͡ʃon/
چون	/t͡ʃuːn/
چونکه	/t͡ʃuːnke/
حاجی	/hɒːd͡ʒiː/
حاد	/hɒːd/
حاشیه	/hɒːʃiːje/
حاشیه نشین	/hɒːʃiːje neʃiːn/
حاضر	/hɒːzeɾ/
حافظه	/hɒːfeze/
حاکم	/hɒːkem/
حالا	/hɒːlɒː/
حالت نهادی	/hɒːlæte næhɒːdiː/
حاملگی	/hɒːmeleɡiː/
حباب	/hebɒːb/
حتی‌الامکان	/hættælemkɒːn/
حتما	/hætmæn/
حج	/hæd͡ʒd͡ʒ/
حجاب	/hed͡ʒɒːb/
حجم	/hæd͡ʒm/
حدیث	/hædiːs/
حیدرآباد	/hejdæɾɒːbɒːd/
حدس	/hæds/
حدس زدن	/hæds zædæn/
حدس زدن	/hædszædæn/
حذر	/hæzæɾ/
حذر کردن	/hæzæɾkæɾdæn/
حرام	/hæɾɒːm/
حیرت	/hejɾæt/
حیرت افتادن	/hejɾætoftɒːdæn/
حیرت کردن	/hejɾætkæɾdæn/
حرص	/heɾs/
حرص زدن	/heɾszædæn/
حرف	/hæɾf/
حریف	/hæɾiːf/
حرف اضافه	/hæɾfe ezɒːfe/
حرف چینی	/hæɾfe t͡ʃiːniː/
حرف ربط	/hæɾfe ɾæbt/
حرف زدن	/hæɾf zædæn/
حرف زدن	/hæɾfzædæn/
حرف گرفتن	/hæɾfɡeɾeftæn/
حرف ندا	/hæɾfe nedɒː/
حرف هان	/hæɾfe hɒːn/
حركت	/hæɾekæt/
حركت دادن	/hæɾekætdɒːdæn/
حركت درآوردن	/hæɾekætdæɾɒːvæɾdæn/
حركت کردن	/hæɾekætkæɾdæn/
حریم	/hæɾiːm/
حزب	/hezb/
حزب‌الله	/hezbollɒːh/
حس	/hes/
حساب	/hesɒːb/
حساب آمدن	/hesɒːbɒːmædæn/
حساب بردن	/hesɒːbboɾdæn/
حسابدار	/hesɒːbdɒːɾ/
حساب کردن	/hesɒːbkæɾdæn/
حسادت	/hesɒːdæt/
حسب حال	/hæsbe hɒːl/
حسد	/hæsæd/
حسد بردن	/hæsædboɾdæn/
حس کردن	/heskæɾdæn/
حسودی	/hæsuːdiː/
حسودی شدن	/hæsuːdiːʃodæn/
حسودی کردن	/hæsuːdiːkæɾdæn/
حشره	/hæʃæɾe/
حشره‌شناسی	/hæʃæɾeʃenɒːsiː/
حشیش	/hæʃiːʃ/
حشیش	/hæŝiːŝ/
حشیش زدن	/hæʃiːʃzædæn/
حشیش کشیدن	/hæʃiːʃkeʃiːdæn/
حشفه	/hæʃæfe/
حصار	/hesɒːɾ/
حصار کشیدن	/hesɒːɾkeʃiːdæn/
حضور	/hozuːɾ/
حضور داشتن	/hozuːɾdɒːʃtæn/
حظ	/hæz/
حظ کردن	/hæzkæɾdæn/
حیفا	/hæiːfɒː/
حفظ	/hefz/
حفظ شدن	/hefzʃodæn/
حفظ کردن	/hefzkæɾdæn/
حق	/hæɢɢ/
حق زدن	/hæɢɢzædæn/
حقیقت	/hæɢiːɢæt/
حقه	/hoɢɢe/
حقه خوردن	/hoɢɢexoɾdæn/
حقه زدن	/hoɢɢezædæn/
حقوق بشر	/hoɢuːɢe bæʃæɾ/
حک	/hæk/
حکایت	/hekɒːjæt/
حکایت کردن	/hekɒːjætkæɾdæn/
حک شدن	/hækʃodæn/
حکمت	/hekmæt/
حکمران	/hokmɾɒːn/
حکومت	/hokuːmæt/
حل	/hæl/
حلال	/hælɒːl/
حلزون	/hælæzuːn/
حل شدن	/hælʃodæn/
حلقه	/hælɢe/
حلقه زدن	/hælɢezædæn/
حلقه کردن	/hælɢekæɾdæn/
حلقوی	/hælɢæviː/
حل کردن	/hælkæɾdæn/
حل کردن	/hæll kæɾdæn/
حیله	/hiːle/
حیله خوردن	/hiːlexoɾdæn/
حیله زدن	/hiːlezædæn/
حلوا	/hɒːlvɒː/
حمایت	/hemɒːjæt/
حمایت کردن	/hemɒːjætkæɾdæn/
حماس	/hæmɒːs/
حماقت	/hemɒːɢæt/
حماقت زدن	/hemɒːɢætzædæn/
حمام	/hæmmɒːm/
حمام رفتن	/hæmmɒːm ɾæftæn/
حمل	/hæml/
حمل شدن	/hæmlʃodæn/
حمل کردن	/hæmlkæɾdæn/
حمله	/hæmle/
حمله آوردن	/hæmleɒːvæɾdæn/
حمله بردن	/hæmleboɾdæn/
حمله کردن	/hæmlekæɾdæn/
حنا	/hænɒː/
حنا	/hennɒː/
حنا زدن	/hænɒːzædæn/
حنجره	/hænd͡ʒæɾe/
حنوکا	/hænuːkɒː/
حواجه‌زاده	/xɒːd͡ʒezɒːde/
حواجه‌سرا	/xɒːd͡ʒesæɾɒː/
حیوان	/hejvɒːn/
حیوانی	/hejvɒːniː/
حوزه	/houːze/
حوله	/hole/
حومه شهر	/huːmeje ʃæhɾ/
یخ	/jæx/
خی	/xiː/
خیابان	/xiːɒːbɒːn/
خیابان	/xiːjɒːbɒːn/
خیابان زدن	/xiːɒːbɒːnzædæn/
خاتم کاری	/xɒːtæm kɒːɾiː/
خاتمه	/xɒːteme/
خاتمه یافتن	/xɒːtemejɒːftæn/
خاتمه دادن	/xɒːtemedɒːdæn/
خاتمه گرفتن	/xɒːtemeɡeɾeftæn/
خاج	/xɒːd͡ʒ/
خار	/xɒːɾ/
خیار	/xiːjɒːɾ/
خارج	/xɒːɾed͡ʒ/
خارجی	/xɒːɾed͡ʒiː/
خارج شدن	/xɒːɾed͡ʒ ʃodæn/
خیارشور	/xiːjɒːɾ ʃuːɾ/
خارطوم	/xɒːɾtuːm/
خارکوف	/xɒːɾkuːv/, /xɒːɾkov/
خارگیل	/xɒːɾɡiːl/
خیاره	/xiːjɒːɾe/
خاس	/xɒːs/
خاص	/xɒːs/
خیّاط	/xæjjɒːt/
خاطر	/xɒːteɾ/
خاطر آوردن	/xɒːteɾɒːvæɾdæn/
خاطرخواه	/xɒːteɾxɒːh/
خاطر داشتن	/xɒːteɾdɒːʃtæn/
خاطر نشان	/xɒːteɾneʃɒːn/
خاطر نشان کردن	/xɒːteɾneʃɒːnkæɾdæn/
خاقان	/xɒːɢɒːn/
خاک	/xɒːk/
خاکی	/xɒːkiː/
خاکزاد	/xɒːkzɒːd/
خاک سپردن	/xɒːksepoɾdæn/
خاکستری	/xɒːkestæɾiː/
خاکی کردن	/xɒːkiː kæɾdæn/
خاک کردن	/xɒːk kæɾdæn/
خاک کردن	/xɒːkkæɾdæn/
خالی	/xɒːliː/
خالق	/xɒːleɢ/
خالی کردن	/xɒːliː kæɾdæn/
خال‌کوبی	/xɒːlkuːbiː/
خاله	/xɒːle/
خاله‌زاده	/xɒːlezɒːde/
خالو	/xɒːluː/
خاموش	/xɒːmuːʃ/
خاموشی	/xɒːmuːʃiː/
خان	/xɒːn/
خیانت	/xiːɒːnæt/
خیانت‌کار	/xiːjɒːnætkɒːɾ/
خیانت کردن	/xiːɒːnætkæɾdæn/
خانتیمانسییسک	/xɒːntiːmɒːnsiːjsk/
خاندان	/xɒːndɒːn/
خانم	/xɒːnom/
خانم‌ها و آقایان	/xɒːnomhɒː væ ɒːɢɒːjɒːn/
خانه	/xɒːnæ/
خانه	/xɒːne/
خانواده	/xɒːnevɒːdæh/
خانواده	/xɒːnevɒːde/
خایه	/xɒːje/
خاویار	/xɒːvjɒːɾ/
خاور	/xɒːvæɾ/
خاور دور	/xɒːvæɾe duːɾ/
خاورمیانه	/xɒːvæɾemiːjɒːne/
خائن	/xɒːʔen/
خبر	/xæbæɾ/
خبر دادن	/xæbæɾdɒːdæn/
خبر شدن	/xæbæɾʃodæn/
خبر کردن	/xæbæɾkæɾdæn/
یخ بستن	/jæxbæstæn/
خبط	/xæbt/
خبط کردن	/xæbtkæɾdæn/
ختم	/xætm/
ختم شدن	/xætmʃodæn/
ختنه	/xætne/
ختنه‌گاه	/xætneɡɒːh/
خجالت	/xed͡ʒɒːlæt/
خجالت کشیدن	/xed͡ʒɒːlætkeʃiːdæn/
یخچال	/jæxt͡ʃɒːl/
خدا	/xodɒː/
خدای پدر	/xodɒːje pedæɾ/
خدا حافظ	/xodɒː hɒːfez/
خداحافظی	/xodɒːhɒːfeziː/
خداحافظی کردن	/xodɒːhɒːfeziːkæɾdæn/
خدایگان	/xodɒːjɡɒːn/
خدا نگهدار	/xodɒː neɡæhdɒːɾ/
خداوند	/xodɒːvænd/
خدمت	/xedmæt/
خدمت کردن	/xedmæt kæɾdæn/
خدمت کردن	/xedmætkæɾdæn/
خر	/xæɾ/
خیر	/xejɾ/
خراب	/xæɾɒːb/
خرابکار	/xæɾɒːbkɒːɾ/
خراب کردن	/xæɾɒːb kæɾdæn/
خرابه	/xæɾɒːbe/
خراش	/xæɾɒːʃ/
خراش افتادن	/xæɾɒːʃoftɒːdæn/
خراش خوردن	/xæɾɒːʃxoɾdæn/
خراش دادن	/xæɾɒːʃdɒːdæn/
خراشیدن	/xæɾɒːʃiːdæn/
خراميدن	/xæɾɒːmiːdæn/
خربزه	/xæɾboze/
خریت	/xæɾiːjjæt/
خریت زدن	/xæɾiːjjætzædæn/
خرج	/xæɾd͡ʒ/
خرج دادن	/xæɾd͡ʒdɒːdæn/
خرج شدن	/xæɾd͡ʒʃodæn/
خرج کردن	/xæɾd͡ʒkæɾdæn/
خرچنگ	/xæɾt͡ʃænɡ/
خرخر	/xoɾxoɾ/
خرخر کردن	/xoɾxoɾkæɾdæn/
خرد	/xeɾæd/
خرد	/xoɾd/
خرداد	/xoɾdɒːd/
خرید رفتن	/xæɾiːd ɾæftæn/
خرید کردن	/xæɾiːd kæɾdæn/
خرد کردن	/xoɾd kæɾdæn/
خرد کردن	/xoɾdkæɾdæn/
خردل	/xæɾdæl/
خردمند	/xeɾædmænd/
خردمندی	/xeɾædmændiː/
خریدن	/xæɾiːdæn/
خرده	/xoɾde/
خرده گرفتن	/xoɾdeɡeɾeftæn/
خرس	/xeɾs/
خرس پاندا	/xeɾse pɒːndɒː/
خرگوش	/xæɾɡuːʃ/
خرگوش كوهی	/xæɾɡuːʃe kuːhiː/
خرما	/xoɾmɒː/
خرمایی	/xoɾmɒːjiː/
خرمارطب	/xoɾmɒːɾotæb/
خرمالو	/xoɾmɒːluː/
خرمائی روشن	/xoɾmɒːjiːje ɾoʃæn/
خرمشهر	/xoɾæmʃæhɾ/
خرمن	/xæɾmæn/
خر و پف	/xoɾ o pof/
خر و پف کردن	/xoɾopofkæɾdæn/
خروج	/xoɾuːd͡ʒ/
خروس	/xoɾuːs/
خروشچف	/xɾuːʃt͡ʃef/
خروشیدن	/xɾuːʃiːdæn/
خیز	/xiːz/
خزان	/xæzɒːn/
یخ زدن	/jæxzædæn/
یخ‌زده	/jæxzæde/
خیز زدن	/xiːzzædæn/
خیزش	/xiːzeŝ/
خیز گرفتن	/xiːzɡeɾeftæn/
خزنده	/xæzænde/
خسارت	/xesɒːɾæt/
خسارت خوردن	/xesɒːɾætxoɾdæn/
خسارت زدن	/xesɒːɾætzædæn/
خیساندن	/xiːsɒːndæn/
خسته	/xæstæ/, /xæste/
خیس کردن	/xiːs kæɾdæn/
خشایارشا	/xæʃɒːjɒːɾʃɒː/
خشایارشا	/xʃɒːjɒːɾʃɒː/
خشایارشاه	/xʃɒːjɒːɾʃɒːh/
خشاب	/xeʃɒːb/
خشت	/xeʃt/
خشک	/xoʃk/
خشک زدن	/xoʃkzædæn/
خشک‌سالی	/xoʃksɒːliː/
خشم	/xæʃm/
خشم آمدن	/xæʃmɒːmædæn/
خشم آوردن	/xæʃmɒːvæɾdæn/
خشم گرفتن	/xæʃmɡeɾeftæn/
خشمگین	/xæʃmɡiːn/
خصم	/xæsm/
خط	/xæt/
خطا	/xætɒː/
خطاب	/xætɒːb/
خطاب کردن	/xætɒːbkæɾdæn/
خطّ استوا	/xætte ostovɒː/
خطاط	/xættɒːt/
خطا کردن	/xætɒːkæɾdæn/
خط تیره	/xætte tiːɾe/
خط خوردن	/xætxoɾdæn/
خطر	/xætæɾ/
خطرناک	/xætæɾnɒːk/
خط زدن	/xætzædæn/
خط فرمان	/xætte fæɾmɒːn/
خطکش	/xætkeʃ/
خط‌کش	/xætkeʃ/
خط‌کش	/xættkeʃ/
خط کشیدن	/xætkeʃiːdæn/
خفاش	/xefɒːʃ/
خفاش	/xoffɒːʃ/
خفتان	/xæftɒːn/
یخ کردن	/jæxkæɾdæn/
یخکوه	/jæxkuːh/
خیلی	/xeiːliː/
خیلی	/xejliː/
خلاصه	/xolɒːse/
خلاصه کردن	/xolɒːsekæɾdæn/
خلاف	/xælɒːf/
خلافت	/xelɒːfet/
خلاف کردن	/xælɒːfkæɾdæn/
خلیج	/xæliːd͡ʒ/
خلیج فارس	/xæliːd͡ʒe fɒːɾs/
خیلی زیاد	/xejliː ziːjɒːd/
خلع سلاح	/xælʔe selɒːh/
خلع سلاح کردن	/xælʔe selɒːhkæɾdæn/
خلیفه	/xæliːfe/
خیلی ممنون	/xejliː mæmnuːn/
خم	/xæm/
خمیازه	/xæmjɒːze/
خمیازه کشیدن	/xæmjɒːzekeʃiːdæn/
خماندن	/xæmɒːndæn/
خمپاره	/xompɒːɾe/
خمپاره خوردن	/xompɒːɾexoɾdæn/
خمپاره زدن	/xompɒːɾezædæn/
خمیدن	/xæmiːdæn/
خم کردن	/xæm kæɾdæn/
خیمه	/xejme/
خین	/xiːn/
خنیا	/xoniːjɒː/
خنجر	/xænd͡ʒæɾ/
خنجر خوردن	/xænd͡ʒæɾxoɾdæn/
خنجر زدن	/xænd͡ʒæɾzædæn/
خندیدن	/xændiːdæn/
خنده	/xænde/
خنده زدن	/xændezædæn/
خنده کردن	/xændekæɾdæn/
خنده گرفتن	/xændeɡeɾeftæn/
خنگ	/xenɡ/
خو	/xuː/
خواب	/xɒːb/
خواب دیدن	/xɒːb diːdæn/
خواب دیدن	/xwɒːb diːdæn/
خوابیدن	/xɒːbiːdæn/
خوابیدن	/xwɒːbiːdæn/
خواب رفتن	/xɒːbɾæftæn/
خواب زدن	/xɒːbzædæn/
خواجگان	/xɒːd͡ʒeɡɒːn/
خواجه	/xɒːd͡ʒe/
خواجه‌ها	/xɒːd͡ʒehɒː/
خوارزم	/xɒːɾæzm/
خواست	/xɒːst/
خواستی	/xɒːstiː/
خواستید	/xɒːstiːd/
خواستگاری	/xɒːsteɡɒːɾiː/
خواستگاری	/xvɒːstɡɒːɾiː/
خواستگاری کردن	/xɒːsteɡɒːɾiːkæɾdæn/
خواستم	/xɒːstæm/
خواستیم	/xɒːstiːm/
خواستن	/xɒːstæn/
خواستن	/xvɒːstæn/
خواستن	/xwɒːstæn/
خواستند	/xɒːstænd/
خواسته	/xɒːste/
خواسته‌ای	/xɒːsteiː/
خواسته‌اید	/xɒːsteiːd/
خواسته است	/xɒːste æst/
خواسته‌ام	/xɒːsteæm/
خواسته‌ایم	/xɒːsteiːm/
خواسته‌اند	/xɒːsteænd/
خواسته باشی	/xɒːste bɒːʃiː/
خواسته باشد	/xɒːste bɒːʃæd/
خواسته باشید	/xɒːste bɒːʃiːd/
خواسته باشم	/xɒːste bɒːʃæm/
خواسته باشیم	/xɒːste bɒːʃiːm/
خواسته باشند	/xɒːste bɒːʃænd/
خواسته بود	/xɒːste búd/
خواسته بودی	/xɒːste búdiː/
خواسته بودید	/xɒːste búdiːd/
خواسته بودم	/xɒːste búdæm/
خواسته بودیم	/xɒːste búdiːm/
خواسته بودند	/xɒːste búdænd/
خواندن	/xɒːndæn/
خواندن	/xwɒːndæn/
خواننده	/xɒːnænde/
خواننده	/xwɒːnænde/
خواننده زن	/xɒːnændeje zæn/
خواه	/xɒːh/
خواهی	/xɒːhiː/
خواهی خواست	/xɒːhí xɒːst/
خواهد	/xɒːhæd/
خواهید	/xɒːhiːd/
خواهد خواست	/xɒːhæd xɒːst/
خواهید خواست	/xɒːhíd xɒːst/
خواهر	/xɒːhæɾ/
خواهر	/xwɒːhæɾ/
خواهرخوانده	/xwɒːhæɾxwɒːnde/
خواهرزاده	/xwɒːhæɾzɒːde/
خواهرزن	/xwɒːhæɾzæn/
خواهرشوهر	/xwɒːhæɾʃoʊhæɾ/
خواهش	/xɒːheʃ/
خواهش کردن	/xɒːheʃ kæɾdæn/
خواهش کردن	/xɒːheʃkæɾdæn/
خواهش می‌کنم	/xɒːheʃ miːkonæm/
خواهش می‌کنم	/xwɒːheʃ miːkonæm/
خواهم	/xɒːhæm/
خواهیم	/xɒːhiːm/
خواهم خواست	/xɒːhæm xɒːst/
خواهیم خواست	/xɒːhím xɒːst/
خواهند	/xɒːhænd/
خواهند خواست	/xɒːhænd xɒːst/
خواهنده	/xɒːhænde/
خوب	/xuːb/
خود	/xod/
خود	/xuːd/, /xod/
خود آمدن	/xodɒːmædæn/
خود آوردن	/xodɒːvæɾdæn/
خودتراش	/xodtæɾɒːʃ/
خودداری	/xoddɒːɾiː/
خودداری کردن	/xoddɒːɾiːkæɾdæn/
خودرو	/xodɾo/
خودرو	/xodɾoʊ/
خودشویی	/xodʃuːjiː/
خودکار	/xodkɒːɾ/
خودکشی	/xodkoʃiː/
خودکشی کردن	/xodkoʃiːkæɾdæn/
خودمختاری	/xodmoxtɒːɾiː/
خودنمایی	/xodnæmɒːiː/
خودنمایی کردن	/xodnæmɒːiːkæɾdæn/
خودنویس	/xodneviːs/
خور	/xuːɾ/
خوراکی	/xoɾɒːkiː/
خوراک سگ	/xoɾɒːk sæɡ/
خوردن	/xoɾdæn/
خوردن	/zædæn/
خورشید	/xoɾʃiːd/
خورشید	/xuːɾʃiːd/
خورشیدفش	/xuːɾʃiːdfæʃ/
خوره	/xoɾe/
خوروران	/xuːɾvæɾɒːn/
خوش	/xoʃ/
خوش	/xoŝ/
خوش آمدی	/xoʃ ɒːmædiː/
خوش آمدید	/xoʃ ɒːmædiːd/
خویشان	/xviːʃɒːn/
خوش اومدی	/xoʃ uːmædiː/
خوش اومدین	/xoʃ uːmædiːn/
خوشبختی	/xoʃʔbàxtiː/
خوشبختانه	/xuːʃbæxtɒːne/
خوشبو	/xoʃbuː/
خوشحال	/xoʃhɒːl/
خوش حال	/xoʃhɒːll/
خوش‌شانس	/xoʃʃɒːns/
خوشگلی	/xoʃɡeliː/
خوشمزه	/xoʃmæzæ/, /xoʃmæze/
خوشمزه	/xuːʃmæze/
خوشنویس	/xoʃneviːs/
خوشنویسی	/xoʃneviːsiː/
خوشه	/xuːʃæ/, /xuːʃe/
خوكچه	/xuːkt͡ʃe/
خوک	/xuːk/
خوکچه هندی	/xuːkt͡ʃeje hendiː/
خوک خاکی	/xuːke xɒːkiː/
خوک نر	/xuːke næɾ/
خو گرفتن	/xuːɡeɾeftæn/
خون	/xuːn/
خون آمدن	/xuːnɒːmædæn/
دی	/dej/
ید	/jod/
دایی	/dɒːjiː/
دیابت	/diːjɒːbet/
دات‌نت	/dɒːtnet/
داخل	/dɒːxel/
داخلی	/dɒːxeliː/
داد	/dɒːd/
داداش	/dɒːdɒːʃ/
داد رسیدن	/dɒːdɾesiːdæn/
داد زدن	/dɒːd zædæn/
داد زدن	/dɒːdzædæn/
داد کشیدن	/dɒːdkeʃiːdæn/
دادگاه	/dɒːdɡɒːh/
دادگری	/dɒːdɡæɾiː/
دادن	/dɒːdæn/
 دادن	/d͡ʒɒːdɒːdæn/
دادن	/oftɒːdæn/
 دادن	/pænddɒːdæn/
 دادن	/pænɒːhdɒːdæn/
 دادن	/tekɒːndɒːdæn/
داده‌ها	/dɒːdehɒː/
دار	/dɒːɾ/
دارایی	/dɒːɾɒːjiː/
داربست	/dɒːɾbæst/
داربست زدن	/dɒːɾbæstzædæn/
داربست کشیدن	/dɒːɾbæstkeʃiːdæn/
دایرةالمعارف	/dɒːjeɾætolmæʔɒːɾef/
دارد می‌خواهد	/dɒːɾæd míxɒːhæd/
دارید می‌خواهید	/dɒːɾiːd míxɒːhiːd/
دار زدن	/dɒːɾ zædæn/
دار زدن	/dɒːɾzædæn/
دار کردن	/dɒːɾkæɾdæn/
دارکوب	/dɒːɾkuːb/
داری می‌خواهی	/dɒːɾiː míxɒːhiː/
دارمشتادیم	/dɒːɾmeʃtɒːdiːom/
دارم می‌خواهم	/dɒːɾæm míxɒːhæm/
داریم می‌خواهیم	/dɒːɾiːm míxɒːhiːm/
دارند می‌خواهند	/dɒːɾænd míxɒːhænd/
دایره	/dɒːjeɾe/
دایره	/dɒːjiːɾe/
دایره زدن	/dɒːjeɾezædæn/
دایره کشیدن	/dɒːjeɾekeʃiːdæn/
دارو	/dɒːɾuː/
دارواش	/dɒːɾvɒːʃ/
داروخانه	/dɒːɾuːxɒːne/
داروساز	/dɒːɾuːsɒːz/
داروسازی	/dɒːɾuːsɒːziː/
داریوش	/dɒːɾjuːʃ/
دارو کوب	/dɒːɾuːkob/
دایی‌زاده	/dɒːjiːzɒːde/
داس	/dɒːs/
داستان	/dɒːstɒːn/
داستان کوتاه	/dɒːstɒːne kuːtɒːh/
داس و چکش	/dɒːs o t͡ʃækoʃ/
داشتید می‌خواستید	/dɒːʃtiːd míxɒːstiːd/
داشتی می‌خواستی	/dɒːʃtiː míxɒːstiː/
داشت می‌خواست	/dɒːʃt míxɒːst/
داشتم می‌خواستم	/dɒːʃtæm míxɒːstæm/
داشتیم می‌خواستیم	/dɒːʃtiːm míxɒːstiːm/
داشتن	/dɒːʃtæn/
داشتند می‌خواستند	/dɒːʃtænd míxɒːstænd/
داغ	/dɒːɢ/
داغ خوردن	/dɒːɢxoɾdæn/
داغ زدن	/dɒːɢzædæn/
داغستان	/dɒːɢestɒːn/
داغ کردن	/dɒːɢkæɾdæn/
دال	/dɒːl/
دال سیاه	/dɒːl e siːjɒːh/
داماد	/dɒːmɒːd/
دامپزشک	/dɒːmpezeʃk/
دامن	/dɒːmæn/
دامن خوردن	/dɒːmænxoɾdæn/
دامن زدن	/dɒːmænzædæn/
دانا	/dɒːnɒː/
دانایی	/dɒːnɒːjiː/
دایناسور	/dɒːjnɒːsoɾ/
دانستن	/dɒːnestæn/
دانش	/dɒːneʃ/
دانش‌آموز	/dɒːneʃɒːmuːz/
دانشجو	/dɒːneʃd͡ʒuː/
دانشكده	/dɒːneʃkæde/
دانشگاه	/dɒːneʃɡɒːh/
دانشمند	/dɒːneʃmænd/
دانشنامه	/dɒːneʃnɒːme/
دانمارک	/dɒːnmɒːɾk/
دانمارکی	/dɒːnmɒːɾkiː/
دانوب	/dɒːnuːb/
دائی	/dɒːʔiː/
دائرةالمعارف	/dɒːʔeɾætolmæʔɒːɾef/
دیباچه	/diːbɒːt͡ʃe/
دباغی	/dæbbɒːɢiː/
دبیر	/dæbiːɾ/
دیپلماسی	/diːplomɒːsiː/
دخالت	/dexɒːlæt/
دخالت کردن	/dexɒːlætkæɾdæn/
دخپسر	/doxpesæɾ/
دختر	/doxtæɾ/
دختر باز	/doxtæɾe bɒːz/
دختر برادر	/doxtæɾe bæɾɒːdæɾ/
دخترخاله	/doxtæɾxɒːle/
دختر خانم	/doxtæɾ xɒːnom/
دخترخوانده	/doxtæɾxwɒːnde/
دختر خواهر	/doxtæɾe xwɒːhæɾ/
دختردایی	/doxtæɾdɒːjiː/
دختردائی	/doxtæɾdɒːʔiː/
دخترعمه	/doxtæɾʔæmme/
دخترعمه	/doxtæɾæmme/
دخترعمو	/doxtæɾʔæmuː/
دخترعمو	/doxtæɾæmuː/
دخیل	/dæxiːl/
دید	/diːd/
دیدار کردن	/diːdɒːɾ kæɾdæn/
دیدبانی دادن	/diːdebɒːniː dɒːdæn/
دید زدن	/diːdzædæn/
دیدن	/diːdæn/
دیده‌بان	/diːdebɒːn/
در	/dæɾ/
دری	/dæɾiː/
دیر	/dejɾ/
دیر	/diːɾ/
دریا	/dæɾjɒː/
دریاچه	/dæɾjɒːt͡ʃe/
دریاچه ارومیه	/dæɾjɒːt͡ʃee oɾuːmiːje/
دریاچه خوارزم	/dæɾjɒːt͡ʃee xoɾæzm/
دریاچهٔ مازندران	/dæɾjɒːt͡ʃejiː mɒːzændæɾɒːn/
دریاچه‌های بزرگ	/dæɾjɒːt͡ʃehɒːje bozoɾɡ/
دریای خزر	/dæɾjɒːje xæzæɾ/
دراییدن	/dæɾɒːjiːdæn/
دراز	/deɾɒːz/
درازا	/deɾɒːzɒː/
دریا زدن	/dæɾjɒːzædæn/
دریای ژاپن	/dæɾjɒːje ʒɒːpon/
دریای سیاه	/dæɾjɒːje siːjɒːh/
دریای سفید	/dæɾjɒːje sæfiːd/
دریای عرب	/dæɾjɒːje ʔæɾæb/
دریافت کردن	/dæɾjɒːft kæɾdæn/
دریاکنار	/dæɾjɒːkenɒːɾ/
دریای مازندران	/dæɾjɒːje mæzændæɾɒːn/
دریای مازندران	/dæɾjɒːje mɒːzændæɾɒːn/
درآمد	/dæɾɒːmæd/
درآمدن	/dæɾɒːmædæn/
درایه	/dæɾɒːje/
درآوردن	/dæɾɒːvæɾdæn/
دربی	/deɾbiː/
دربارۀ	/dæɾbɒːɾeje/
دربند کردن	/dæɾbænd kæɾdæn/
دیرتر	/diːɾtæɾ/
درجا	/dæɾd͡ʒɒː/
درجا زدن	/dæɾd͡ʒɒːzædæn/
درجه	/dæɾæd͡ʒe/
در حال	/dæɾ hɒːle/
درخت	/deɾæxt/, /dæɾæxt/
درخت آزاد	/deɾæxte ɒːzɒːd/
درخت نارنج	/deɾæxte nɒːɾend͡ʒ/
درخشان	/dɾæxʃɒːn/
درخشان	/deɾæxʃɒːn/
درخواست دادن	/dæɾxɒːst dɒːdæn/
درخواستن	/dæɾxɒːstæn/
درد	/dæɾd/
درد آمدن	/dæɾdɒːmædæn/
درد آوردن	/dæɾdɒːvæɾdæn/
درد خوردن	/dæɾdxoɾdæn/
درد دل	/dæɾde del/
درد دل کردن	/kæɾdæn/
دردسر	/dæɾdesæɾ/
درد کردن	/dæɾdkæɾdæn/
درد کشیدن	/dæɾdkeʃiːdæn/
درد گرفتن	/dæɾdɡeɾeftæn/
در راه	/dæɾ ɾɒːh/
درز	/dæɾz/
درزی	/dæɾziː/
در زدن	/dæɾ zædæn/
در زدن	/dæɾzædæn/
درز کردن	/dæɾzkæɾdæn/
درز گرفتن	/dæɾzɡeɾeftæn/
در زمان	/dæɾ zæmɒːne/
درس	/dæɾs/
درست	/doɾost/
درستی	/doɾostiː/
درستی سنجی	/doɾostiː sænd͡ʒiː/
درستکار	/doɾostkɒːɾ/
درست کردن	/doɾost kæɾdæn/
درس خواندن	/dæɾs xɒːndæn/
درس دادن	/dæɾs dɒːdæn/
درس دادن	/dæɾsdɒːdæn/
در سمت چپ	/dæɾ semet t͡ʃæp/
در سمت راست	/dæɾ semet ɾɒːst/
درصد	/dæɾsæd/
دریغ	/dæɾiːɢ/
در غیر این صورت	/dæɾ ɢejɾe iːn suːɾæt/
دریغ کردن	/dæɾiːɢkæɾdæn/
درک	/dæɾk/
دیرکرد	/diːɾkæɾd/
درک کردن	/dæɾkkæɾdæn/
درگاه	/dæɾɡɒːh/
درگذشتن	/dæɾɡozæʃtæn/
درگر	/doɾɡæɾ/
درگوشی	/dæɾeɡuːʃiː/
در میان	/dæɾ miːjɒːne/
درمان	/dæɾmɒːn/
درمانگاه	/dæɾmɒːnɡɒːhʔ/
در منزل	/dæɾ mænzel/
دیرین	/diːɾiːn/
درنگ	/dɾænɡ/
درنگ	/deɾænɡ/
درنگ كردن	/dɾænɡ kæɾdæn/
درنگ کردن	/deɾænɡkæɾdæn/
درنهایت	/dæɾnæhɒːjæt/
دره	/dæɾe/, /dæɾɾe/
درود	/doɾuːd/
درودگر	/doɾuːdɡæɾ/
درویدن	/dɾæviːdæn/
درودن	/doɾuːdæn/
درودن	/dɾuːdæn/
دیروز	/diːɾuːz/
دیروز صبح	/diːɾuːz sobh/
دیروز غروب	/diːɾuːz ɢoɾuːb/
درویش	/dæɾviːʃ/
دروغ	/doɾuːɢ/
دروغ گفتن	/doɾuːɢ ɡoftæn/
دروغ گفتن	/doɾuːɢɡoftæn/
درون	/dæɾuːn/
درونی	/dæɾuːniː/
دزد	/dozd/
دزدی	/dozdiː/
دزدیدن	/dozdiːdæn/
دزد زدن	/dozdzædæn/
دزدی کردن	/dozdiːkæɾdæn/
دژ	/deʒ/
دژخیم	/doʒxiːm/
دیسال	/diːsɒːl/
دسامبر	/desɒːmbɾ/
دست	/dæst/
دستار	/dæstɒːɾ/
دست اره	/dæstæɾɾe/
دست آمدن	/dæstɒːmædæn/
دستاورد	/dæstɒːvæɾd/
دست آوردن	/dæstɒːvæɾdæn/
دستبرد	/dæstboɾd/
دستبرد زدن	/dæstboɾdzædæn/
دستبند	/dæstbænd/
دستبند خوردن	/dæstbændxoɾdæn/
دستبند زدن	/dæstbændzædæn/
دست‌خط	/dæstxæt/
دست خوردن	/dæstxoɾdæn/
دست دادن	/dæstdɒːdæn/
دستره	/dæstæɾe/
دست زدن	/dæst zædæn/
دست زدن	/dæstzædæn/
دستشویی	/dæstʃuːtiː/
دستکش	/dæstkeʃ/
دست کشیدن	/dæst kæʃiːdæn/
دست کشیدن	/dæstkeʃiːdæn/
دست کم گرفتن	/dæst e kæm ɡeɾeftæn/
دستگاه	/dæstɡɒːh/
دستگاه تناسلی	/dæstɡɒːhe tænɒːsoliː/
دستمال	/dæstmɒːl/
دستمال کشیدن	/dæstmɒːlkeʃiːdæn/
دست‌مزد	/dăstmozd/
دست نخورده	/dɒːst næxoɾde/
دست‌نویس	/dæstneviːs/
دست‌نویسی	/dæstneviːsiː/
دست‌نوشته	/dæstneveʃte/
دسته	/dæstæ/
دسته	/dæstæ/, /dæste/
دسته پزندگان	/dæsteje pæɾændeɡɒːn/
دست و پا	/dæst o pɒː/
دست و پا زدن	/dæstopɒːzædæn/
دست و پا کردن	/dæstopɒːkæɾdæn/
دستور	/dæstuːɾ/
دستور دادن	/dæstuːɾdɒːdæn/
دستور زبان	/dæstuːɾe zæbɒːn/
دستور گرفتن	/dæstuːɾɡeɾeftæn/
دسر	/deseɾ/
دیسک سخت	/diːske sæxt/
ییدیش	/jiːdiːʃ/
دیشب	/diːʃæb/
دشت	/dæʃt/
دشت زدن	/dæʃtzædæn/
دشمن	/doʃmæn/
دشمنی	/doʃmæniː/
دشنام	/doʃnɒːm/
دشنام دادن	/doʃnɒːmdɒːdæn/
دشوار	/doʃvɒːɾ/
دعا	/doʔɒː/
دعا کردن	/doʔɒː kæɾdæn/
دعا کردن	/doʔɒːkæɾdæn/
دعوا	/dæʔvɒː/
دعوا شدن	/dæʔvɒːʃodæn/
دعوا کردن	/dæʔvɒːkæɾdæn/
دعوت	/dæʔvæt/
دعوت داشتن	/dæʔvætdɒːʃtæn/
دعوت كردن	/dævæt kæɾdæn/
دعوت کردن	/dæʔvætkæɾdæn/
دفاع	/defɒːʔ/
دفاع کردن	/defɒːʔkæɾdæn/
دفتر	/dæftæɾ/
دفترچه	/dæftæɾt͡ʃe/
دفن	/dæfn/
دفن کردن	/dæfn kæɾdæn/
دفن کردن	/dæfnkæɾdæn/
دق	/deɢ/
دق آمدن	/deɢɒːmædæn/
دق آوردن	/deɢɒːvæɾdæn/
دقیق	/dæɢiːɢ/
دقیقه	/dæɢiːɢe/
دق کردن	/deɢkæɾdæn/
دكان نانوائی	/dokɒːn nɒːnevɒːʔiː/
یدک	/jædæk/
دکان	/dokkɒːn/
دکان	/dokɒːn/
دکان زدن	/dokkɒːnzædæn/
دیکتاتور	/diːktɒːtoɾ/
دیکتاتوری	/diːktɒːtuːɾiː/
دکتر	/doktoɾ/
دکتر داروساز	/doktoɾe dɒːɾuːsɒːz/
دکتر زایمان	/doktoɾe zɒːjemɒːn/
دکتر زنان	/doktoɾe zænɒːn/
دکتر کودکان	/doktoɾe kuːdækɒːn/
یدک کشیدن	/jædækkeʃiːdæn/
دکوراسیون	/dekoɾɒːsjon/
دیگ	/diːɡ/
دیگ	/dîɡ/
دیگ به دیگ می‌گه روت سیاه	/diːɡ be diːɡ miːɡe ɾuːt siːjɒːh/
دیگر	/diːɡæɾ/
دگربار	/deɡæɾbɒːɾ/
دگرجنس‌گرایی	/deɡæɾd͡ʒensɡæɾɒːjiː/
دگرگونی	/deɡæɾɡuːniː/
دگمه	/doɡmæ/, /doɡme/
دگمه	/doɡme/
دل	/del/
دلار	/dolɒːɾ/
دلارام	/delɒːɾɒːm/
دلبر	/delbæɾ/
دلپذیر	/delpæziːɾ/
دلداده	/deldɒːde/
دلدار	/deldɒːɾ/
دلدرد	/deldæɾd/
دلدرد زدن	/deldæɾdzædæn/
دلربا	/delɾobɒː/
دل سوختن	/del suːxtæn/
دلشوره	/delʃuːɾe/
دلشوره گرفتن	/delʃuːɾeɡeɾeftæn/
دلفریب	/delfæɾiːb/
دلفین	/dolfiːn/
دلکش	/delkæʃ/
دلنواز	/delnævɒːz/
دلو	/dæluː/
دم	/dæm/
دم	/dom/
دمار	/dæmɒːɾ/
دماغ	/dæmɒːɢ/
دماغ گرفتن	/dæmɒːɢɡeɾeftæn/
دمبل	/dæmbel/
دمبل زدن	/dæmbelzædæn/
دم‌جنبانک	/domd͡ʒombɒːnæk/
دم زدن	/dæmzædæn/
دمشق	/demeʃɢ/
دم گرفتن	/dæmɡeɾeftæn/
دموکراتیک	/demokɾɒːtiːk/
دموکراسی	/demuːkɾɒːsiː/
دین	/diːn/
دنیا	/donjɒː/
دنیا آمدن	/donjɒːɒːmædæn/
دنیا آوردن	/donjɒːɒːvæɾdæn/
دنبال	/donbɒːl/
دنبال کردن	/donbɒːl kæɾdæn/
دنبال کردن	/donbɒːlkæɾdæn/
دنبال گشتن	/donbɒːl ɡæʃtæn/
دنبال گشتن	/donbɒːlɡæʃtæn/
دندان	/dændɒːn/
دندان‌پزشک	/dændɒːnpezeʃk/
دندان پزشکی	/dændɒːn pezeʃkiː/
دندان زدن	/dændɒːnzædæn/
دندانساز	/dændɒːnsɒːz/
دنده	/dænde/
دنگ	/donɡ/
ده	/dæh/
ده	/de/
دهان	/dæhɒːn/
دهانی	/dæhɒːniː/
دهانه	/dæhɒːne/
دهدهی	/dæhdæhiː/
دهلی	/dehliː/
دهلی نو	/dehliː nouː/
دهم	/dæhom/
دهن	/dæhæn/
دهن / دهان	/dæhæn/
دهن / دهان خوردن	/dæhænxoɾdæn/
دهن / دهان زدن	/dæhænzædæn/
دهه	/dæhe/
دو	/do/
دوات	/dævɒːt/
دیوار	/diːvɒːɾ/
دوازده	/dævɒːzdæh/
دیوان	/diːvɒːn/
دیوانگی	/diːvɒːneɡiː/
دیوانگی زدن	/diːvɒːneɡiːzædæn/
دیوانه	/diːvɒːne/
دوباره!	/dobɒːɾe/
دوباره	/dobɒːɾe/
دوبالان	/dobɒːlɒːn/
دوپیکر	/dopejkæɾ/
دوجین	/dod͡ʒiːn/
دوجنسه	/dod͡ʒense/
دوچرخه	/dot͡ʃæɾxe/
دوچرخه‌سوار	/dot͡ʃæɾxesævɒːɾ/
دوحه	/duːhe/
دوختن	/duːxtæn/
دود	/duːd/
دود زدن	/duːdzædæn/
دود کردن	/duːdkæɾdæn/
دودمانه	/duːdmɒːne/
دویدن	/dæviːdæn/
دودویی	/dodojiː/
دودوئی	/dodoiː/
دور	/doʊɾ/
دور	/douːɾ/
دور	/duːɾ/
دوریان	/duːɾiːɒːn/
دور انداختن	/duːɾ ændɒːxtæn/
دوران طلایی	/doɾɒːn tælæʔeiː/
دوربین	/duːɾbiːn/
دوربین دیجیتال	/duːɾbiːne diːd͡ʒiːtɒːl/
دور زدن	/doʊɾ zædæn/
دور زدن	/doʊɾzædæn/
دور گرفتن	/doʊɾɡeɾeftæn/
دورنگار	/doɾneɡɒːɾ/
دورنگاریدن	/duːɾneɡɒːɾiːdæn/
دوره	/doɾæ/, /doɾe/
دوره	/doɾe/
دوره	/douːɾe/
دورواژ	/duːɾvɒːʒ/
دورواژیدن	/duːɾvɒːʒiːdæn/
دو زار	/do zɒːɾ/
دو زار و ده شاهی	/do zɒːɾ o dæh ʃɒːhiː/
دوزخ	/duːzæx/
دو زدن	/dozædæn/
دو زن داری	/dô zæn dɒːɾiː/
دویست	/deviːst/
دوست	/duːst/
دوستی	/duːstiː/
دوست‌پسر	/duːstpesæɾ/
دوستدار	/duːstdɒːɾ/
دوست داشتن	/duːst dɒːʃtæn/
دوست داشتن	/duːstdɒːʃtæn/
دوست‌دختر	/duːstdoxtæɾ/
دوستی کردن	/duːstiː kæɾdæn/
دوست مکاتبه‌ای	/doste mokɒːtebeɒːjiː/
دوسره	/dosæɾe/
دوش	/duːʃ/
دوشیدن	/duːʃiːdæn/
دوشیزه	/douːʃiːze/
دوشیزه	/duːʃiːze/
دوشس	/duːʃes/
دوش گرفتن	/duːʃ ɡeɾeftæn/
دوشنبه	/doʃæmbe/
دوشنبه	/doʃænbe/
دوک	/duːk/
دولت	/doʊlæt/
دولت	/douːlæt/
دولت اسرائیل	/douːlæte esɾɒːʔiːl/
دوم	/dovvom/
دوناگری	/devænɒːɡæɾiː/
دون ژوان	/don ʒovɒːn/
دونقطه	/donoɢte/
دينار	/diːnɒːɾ/
ديوانه	/diːvɒːne/
ذات	/zɒːt/
ذرت	/dhoɾæt/
ذرت	/zoɾɾæt/
ذره‌بین	/zæɾɾebiːn/
ذهن	/zehn/
ذهنیت	/zehniːjjæt/
ذوق	/zoʊɢ/
ذوق زدن	/zoʊɢzædæn/
رأی	/ɾɒːʔiː/
رایانامه	/ɾɒːjɒːnɒːme/
رایانه	/ɾɒːjɒːne/
رابین‌هود	/ɾɒːbjnhuːd/
رایج	/ɾɒːjed͡ʒ/
راجا	/ɾɒːd͡ʒɒː/
راجع به	/ɾɒːd͡ʒeʔ be/
راحت	/ɾɒːhæt/
راحت‌الحلقوم	/ɾɒːhætelholɢuːm/
راد	/ɾɒːd/
رادیو	/ɾɒːdiːo/
رادون	/ɾɒːdon/
راديوم	/ɾɒːdiːjuːm/
راز	/ɾɒːz/
رازآميز	/ɾɒːzɒːmiːz/
راست	/ɾɒːst/
راست‌گرا	/ɾɒːstɡæɾɒː/
راش	/ɾɒːʃ/
ریاضی	/ɾiːjɒːziː/
رافائل	/ɾɒːfɒːʔel/
راک اند رول	/ɾɒːk ɒːnd ɾol/
رآکتور هسته‌ای	/ɾeɒːktoɾe hæsteʔiː/
رایگان	/ɾɒːjɡɒːn/
راگبی	/ɾɒːɡbiː/
ریال	/ɾiːɒːl/
رامی	/ɾɒːmiː/
رامی زدن	/ɾɒːmiːzædæn/
رامن	/ɾɒːmen/
رامنی	/ɾɒːmniː/
ران	/ɾɒːn/
راندن	/ɾɒːndæn/
راننده	/ɾɒːnænde/
راه	/ɾɒːh/
راه ابریشم	/ɾɒːhe æbɾiːʃæm/
راه افتادن	/ɾɒːhoftɒːdæn/
راه یافتن	/ɾɒːhjɒːftæn/
راه انداختن	/ɾɒːhændɒːxtæn/
راه‌آهن	/ɾɒːh ɒːhæn/
راهب	/ɾɒːheb/
راهبرد	/ɾɒːhboɾd/
راه رسیدن	/ɾɒːhɾesiːdæn/
راهرو	/ɾɒːhɾo/
راه شاهی	/ɾɒːhe ʃɒːhiː/
راه شیری	/ɾɒːhe ʃiːɾiː/
راولپندی	/ɾɒːvɒːlpendiː/
ربع	/ɾobʔ/
ربه‌کا	/ɾebekɒː/
رتیل	/ɾotejl/
ریتم	/ɾiːtm/
رجم	/ɾæd͡ʒm/
ریچارد	/ɾiːt͡ʃɒːɾd/
رحم	/ɾæhem/
رحم	/ɾæhm/
رحم آمدن	/ɾæhmɒːmædæn/
رحم آوردن	/ɾæhmɒːvæɾdæn/
رحمت	/ɾæhmæt/
رحمت آوردن	/ɾæhmætɒːvæɾdæn/
رحمت کردن	/ɾæhmætkæɾdæn/
رحم کردن	/ɾæhmkæɾdæn/
رحم گرفتن	/ɾæhmɡeɾeftæn/
رخ	/ɾox/
رختخواب	/ɾæxtexɒːb/
ریختن	/ɾiːxtæn/
رخسار	/ɾoxsɒːɾ/
رد	/ɾæd/
رد شدن	/ɾædʃodæn/
رد کردن	/ɾædkæɾdæn/
ریدن	/ɾiːdæn/
رده بندی	/ɾæde bændiː/
رده‌بندی	/ɾædebændiː/
رد و بدل	/ɾæd o bædæl/
رد و بدل شدن	/ɾædobædælʃodæn/
رد و بدل کردن	/ɾædobædælkæɾdæn/
ریز	/ɾiːz/
ریزبین	/ɾiːzbiːn/
رزیدن	/ɾæziːdæn/
رزرو کردن	/ɾezeɾv kæɾdæn/
رژ لب	/ɾoʒe læb/
رژیم	/ɾeʒiːm/
رساندن	/ɾesɒːndæn/
رسانه	/ɾesɒːne/, /ɾæsɒːne/
رسانه گروهی	/ɾæsɒːneʔ je ɡoɾuːhiːʔ/, /ɾesɒːneʔ je ɡoɾuːhiːʔ/
رسانه‌های گروهی	/ɾæsɒːnehɒːje ɡoɾuːhiː/
رستاخیز	/ɾæstɒːxiːz/
رستاخیز شدن	/ɾæstɒːxiːz ŝodæn/
رستگاری	/ɾæstɡɒːɾiː/
رستوران	/ɾestoɾɒːn/
رسیدگی	/ɾesiːdeɡiː/
رسیدگی کردن	/ɾesiːdeɡiːkæɾdæn/
رسیدن	/ɾæsiːdæn/, /ɾesiːdæn/
رسیدن	/ɾesiːdæn/
رسیدن	/ræsiːdæːn/
رسم	/ɾæsm/
رسم کردن	/ɾæsmkæɾdæn/
ریش	/ɾiːʃ/
رشته	/ɾeʃte/
ریش زدن	/ɾiːʃzædæn/
رشک	/ɾæʃk/
رشک ورزیدن	/ɾæʃk væɾziːdæn/
ریشه	/ɾiːʃæ/
ریشه	/ɾiːʃe/
ریشه زدن	/ɾiːʃezædæn/
ریشه‌شناسی	/ɾiːʃeʃenɒːsiː/
رضایت	/ɾezɒːjæt/
رضایت دادن	/ɾezɒːjætdɒːdæn/
رعد	/ɾæʔd/
رعد زدن	/ɾæʔdzædæn/
رغبت	/ɾeɢbæt/
رغبت کردن	/ɾeɢbætkæɾdæn/
رف	/ɾæf/
رفتن	/ɾæftæn/
رفتن	/ɾoftæn/
رفیق	/ɾæfiːɢ/
رقاص	/ɾæɢɢɒːs/
رقّاص	/ɾæɢɢɒːs/
رقیب	/ɾæɢiːb/
رقص	/ɾæɢs/
رقص باله	/ɾæɢse bɒːle/
رقصیدن	/ɾæɢsiːdæn/
رقص عربی	/ɾæɢs ʔæɾæbiː/
رقص کردن	/ɾæɢs kæɾdæn/
رقم	/ɾæɢæm/
رکاب	/ɾekɒːb/
رکاب زدن	/ɾekɒːbzædæn/
رکسانه	/ɾoksɒːne/
رکيک	/ɾækiːk/
رگ	/ɾæɡ/
ریگ	/ɾiːɡ/
رگ زدن	/ɾæɡzædæn/
رم	/ɾæm/
رم	/ɾom/
رمان	/ɾomɒːn/
رم دادن	/ɾæmdɒːdæn/
رمزگذاری	/ɾæmzɡozɒːɾiː/
رمزنگاری	/ɾæmzneɡɒːɾiː/
رمضان	/ɾæmæzɒːn/
رم کردن	/ɾæmkæɾdæn/
ریمل	/ɾiːmel/
ریمل زدن	/ɾiːmelzædæn/
رنج	/ɾænd͡ʒ/
رنج بردن	/ɾænd͡ʒboɾdæn/
رنج دادن	/ɾænd͡ʒdɒːdæn/
رنج کشیدن	/ɾænd͡ʒkeʃiːdæn/
رنده	/ɾænde/
رنسانس	/ɾonesɒːns/
رنگ	/ɾænɡ/
رنگارنگ	/ɾænɡɒːɾænɡ/
رنگ زیتونی	/ɾænɡ zæiːtuːniː/
رنگ زدن	/ɾænɡzædæn/
رنگ صورتی	/ɾænɡ suːɾætiː/
رنگ کردن	/ɾænɡ kæɾdæn/
رنگ کردن	/ɾænɡkæɾdæn/
رنگین	/ɾænɡiːn/
رنگین‌کمان	/ɾænɡiːnkæmɒːn/
ریه	/ɾiːje/
رها	/ɾæhɒː/
رها کردن	/ɾæhɒː kæɾdæn/
رهبر	/ɾæhbæɾ/
رهبر ارکستر	/ɾæhbæɾe oɾkestɾ/
رهبر جامعه اسلامی	/ɾæhbæɾe d͡ʒɒːmeʔeje eslæmiː/
روی	/ɾuːj/
روایت	/ɾævɒːjæt/
روایت شدن	/ɾævɒːjætʃodæn/
رواج	/ɾævɒːd͡ʒ/
رواج یافتن	/ɾævɒːd͡ʒjɒːftæn/
رواج دادن	/ɾævɒːd͡ʒdɒːdæn/
روادید	/ɾævɒːdiːd/
رویارویی	/ɾuːjɒːɾuːʔiː/
روان	/ɾævɒːn/
روان پزشک	/ɾævɒːnʔ pezeʃkʔ/
روان شناس	/ɾævɒːnʃenɒːs/
روان‌شناس	/ɾævɒːnʃenɒːs/
روان‌شناسی	/ɾævɒːnʃenɒːsiː/
روانکاو	/ɾævɒːnʔkɒːv/
روان‌نویس	/ɾævɒːnneviːs/
روايت	/ɾævɒːjæt/
روايت کردن	/ɾævɒːjætkæɾdæn/
روباه	/ɾuːbɒːh/
روبل	/ɾuːbl/
روبنده	/ɾuːbænde/
رو به راه	/ɾuː be ɾɒːh/
رو پوشانی	/ɾuː puːʃɒːniː/
روتیل	/ɾuːtiːl/
روح	/ɾuːh/
رود	/ɾuːd/
رودخانه	/ɾuːdxɒːne/
رودخونه	/ɾuːdxuːne/
رودست	/ɾuːdæst/
رودست خوردن	/ɾuːdæstxoɾdæn/
رودست زدن	/ɾuːdæstzædæn/
روده	/ɾuːde/
روز	/ɾuːz/
روزی از روزها	/ɾuːziː æz ɾuːzhɒː/
روزانه	/ɾuːzɒːne/
روز بخیر	/ɾuːz bexejɾ/
روز پیروزی	/ɾuːze piːɾuːziː/
روزی روزگاری	/ɾuːziː ɾuːzeɡɒːɾiː/
روز شکرگزاری	/ɾuːze ʃokɾɡozɒːɾiː/
روزنامه	/ɾuːznɒːme/
روزنامه‌نگار	/ɾuːznɒːmeneɡɒːɾ/
روزنامه‌نگاری	/ɾuːznɒːmeneɡɒːɾiː/
روزه	/ɾozæ/
روزه	/ɾuːze/
روزه گرفتن	/ɾuːze ɡeɾeftæn/
روس	/ɾuːs/
روسی	/ɾuːsiː/
روسپی‌خانه	/ɾuːspiːxɒːne/
روسپی‌گری	/ɾuːspiːɡæɾiː/
روستا	/ɾuːstɒː/
روستایی	/ɾuːstɒːʔiː/
روستایی	/ɾuːstɒːjiː/
روی سخته	/ɾuːj sæxte/
روسری	/ɾuːsæɾiː/
روسیه	/ɾuːsiːje/
روسیه سفید	/ɾuːsiːjeje sefiːd/
روش	/ɾæveʃ/
روش علمی	/ɾæveʃe elmiː/
روشن	/ɾoʊʃæn/
روشن	/ɾoʃæn/
روشن	/ɾoŝæn/
روشن	/ɾouːʃæn/
روشنا	/ɾoʊʃænɒː/
روشنک	/ɾoʊʃænæk/
روشن کردن	/ɾoʊʃæn kæɾdæn/
روشنگری	/ɾoʃænɡæɾiː/
روغن	/ɾoʊɢæn/
روغن	/ɾuːɢæn/
روغن زدن	/ɾoʊɢænzædæn/
رولت روسی	/ɾuːlet ɾuːsiː/
روم	/ɾuːm/
رومی	/ɾuːmiː/
رومانی	/ɾuːmɒːniː/
رومانیایی	/ɾuːmɒːniːjɒːjiː/
رومانیکا	/ɾuːmɒːniːkɒː/
رومنی	/ɾuːmniː/
روندن	/ɾuːndæn/
رونویسی	/ɾuːneviːsiː/
رونوشت	/ɾuːneveʃt/
رویه	/ɾuːjæ/
رئیس جمهور	/ɾæʔiːse d͡ʒomhuːɾ/
زیاد	/ziːjɒːd/
زیادروی	/ziːɒːdeɾæviː/
زیادروی کردن	/ziːɒːdeɾæviːkæɾdæn/
زادگاه	/zɒːdɡɒːh/
زاییدن	/zɒːjiːdæn/
زار	/zɒːɾ/
زاری	/zɒːɾiː/
زار زدن	/zɒːɾzædæn/
زاری کردن	/zɒːɾiːkæɾdæn/
زازاکی	/zɒːzɒːkiː/
زاغ	/zɒːɢ/
زاگرب	/zɒːɡɾeb/
زاگرس	/zɒːɡɾos/
زالتسبورگ	/zɒːlsbuːɾɡ/
زالو	/zɒːluː/
زیان	/ziːjɒːn/
زیانشانه‌شناسی	/ziːɒːneʃæneʃenɒːs/
زانو	/zɒːnuː/
زانو زدن	/zɒːnuː zædæn/
زائر	/zɒːʔeɾ/
زیبا	/ziːbɒː/
زبان	/zæbɒːn/
زبان آبخازی	/zæbɒːn ɒːbxɒːziː/
زبان آفریکانز	/zæbæne ɒːfɾiːkɒːnz/
زبان آفریکانس	/zæbɒːne ɒːfɾiːkɒːns/
زبان آمدن	/zæbɒːnɒːmædæn/
زبان انگلیسی	/zæbɒːne enɡeliːsiː/
زبان اودی	/zæbɒːn uːdiː/
زبان آوردن	/zæbɒːnɒːvæɾdæn/
زبان برمه‌ای	/zæbɒːne beɾmeʔɒːjiː/
زبان‌ برنامه‌نویسی	/zæbɒːne bæɾnɒːmeneviːsiː/
زبان بلوچی	/zæmɒːne bæluːt͡ʃiː/
زبان پالائی	/zæbɒːne pɒːlɒːʔiː/
زبان تاجیکی	/zæbɒːne tɒːd͡ʒiːkiː/
زبان تامیل	/zæbɒːne tɒːmiːl/
زبان چینی	/zæbɒːne t͡ʃiːniː/
زبان خارجی	/zæbɒːne xɒːɾed͡ʒiː/
زبان خمر	/zæbɒːne xæmeɾ/
زبان دیوهی	/zæbɒːn diːvehiː/
زبان روسی	/zæbɒːne ɾuːsiː/
زبان زدن	/zæbɒːnzædæn/
زبان ژاپنی	/zæbɒːne ʒɒːponiː/
زبان سانسکریت	/zæbɒːne sɒːnskɾiːt/
زبان‌شناس	/zæbɒːnʃenæs/
زبان‌شناسی	/zæbɒːnʃenɒːsiː/
زبان طبیعی	/zæmɒːne tæbiːʔiː/
زبان فارسی	/zæbɒːne fɒːɾsiː/
زبان قرقیزی	/zæbɒːne ɢiːɾɢiːziː/
زبان قزاقی	/zæbɒːne ɢæzɒːɢiː/
زبان کانارا	/zæbɒːn kænæɾæ/
زبان کشیدن	/zæbɒːnkeʃiːdæn/
زبان لاتین	/zæbɒːne lɒːtiːn/
زبان مادری	/zæbɒːne mɒːdæɾiː/
زبان ماشین	/zæbɒːne mæʃiːn/
زبان مالایی	/zæbɒːne mɒːlɒːjiː/
زبان میانجی	/zæbɒːne miːjɒːnd͡ʒiː/
زبانه	/zæbɒːne/
زبانه زدن	/zæbɒːnezædæn/
زبانه کشیدن	/zæbɒːnekeʃiːdæn/
زبر	/zæbæɾ/, /zebæɾ/
زبردستی	/zebæɾdæstiː/
زتا	/zetɒː/
زیتونی	/zejtuːniː/
زجر	/zæd͡ʒɾ/
زجر دادن	/zæd͡ʒɾdɒːdæn/
زجر کشیدن	/zæd͡ʒɾkeʃiːdæn/
زحل	/zohæl/
زحمت	/zæhmæt/
زحمت افتادن	/zæhmætoftɒːdæn/
زحمت کشیدن	/zæhmætkeʃiːdæn/
زخم	/zæxm/
زخمی	/zæxmiː/
زخم خوردن	/zæxmxoɾdæn/
زخم زبان	/zæxme zæbɒːn/
زخم زبان زدن	/zæxmezæbɒːnzædæn/
زخم زدن	/zæxmzædæn/
زخمه	/zæxme/
زید	/zejd/
یزدان	/jæzdɒːn/
زدن	/zædæn/
زدودن	/zoduːdæn/
زر	/zæɾ/
زر	/zeɾ/
زیر	/ziːɾ/
زیرا	/ziːɾɒː/
زیرآبی	/ziːɾɒːbiː/
زیرآبی زدن	/ziːɾɒːbiːzædæn/
زرافه	/zæɾɾɒːfe/
زرّافه	/zæɾɾɒːfe/
زیربغل	/ziːɾbæɢæl/
زیر پوشی زن	/ziːɾ puːʃiː zæn/
زرتشتی	/zæɾtoʃtiː/
زرد	/zæɾd/
زردآلو	/zæɾdɒːluː/
زردچوبه	/zæɾdt͡ʃuːbe/
زرد چوبه	/zæɾdt͡ʃuːbe/
زرد چوبه زدن	/zæɾdt͡ʃuːbezædæn/
زیردریایی	/ziːɾdæɾjɒːjiː/
زرد معتدل	/zæɾde moʔtædel/
زر زدن	/zeɾzædæn/
زیرزمین	/ziːɾzæmiːn/
زیر سیگاری	/ziːɾsiːɡɒːɾiː/
زیرشیروانی	/ziːɾeʃiːɾvɒːniː/
زرشک	/zeɾeʃk/
زرشکی	/zeɾeʃkiː/
زیرصفحه	/ziːɾsæfhe/
زیرک	/ziːɾæk/
زرین	/zæɾɾiːn/
زرین	/zæɾiːn/
زیره‌ی سیاه	/ziːɾeje siːjɒːh/
زیره‌ی سبز	/ziːɾeje sæbz/
زیست	/ziːst/
زیست‌شیمی	/ziːstʃiːmiː/
زیست‌شناسی	/ziːstʃenɒːsiː/
زیستن	/ziːstæn/
زشت	/zeʃt/
زعفران	/zæʔfeɾɒːn/
زعفرانی	/zæʔfeɾɒːniː/
زغن	/zæɢæn/
زق	/zeɢ/
زق زدن	/zeɢzædæn/
زکام	/zokɒːm/
زیگ	/ziːɡ/
زل	/zol/
زلاند جدید	/zelɒːnde d͡ʒædiːd/
زلاند نو	/zelɒːnde nouː/
زل زدن	/zolzædæn/
زلزله	/zelzele/
زلزله‌شناسی	/zelzeleʃenɒːsiː/
زلکوا	/zelkovɒː/
زمان	/zæmɒːn/
زمانی که	/zæmɒːniː ke/
زمرد	/zomoɾɾod/
زمردی	/zomoɾɾodiː/
زمزمه	/zemzeme/
زمزمه کردن	/zemzemekæɾdæn/
زمستان	/zemestɒːn/
زمین	/zæmiːn/
زمین خوردن	/zæmiːnxoɾdæn/
زمین زدن	/zæmiːnzædæn/
زمینی‌سازی	/zæmiːniːsɒːziː/
زمین‌شناسی	/zæmiːnʃenɒːsiː/
زمین‌شناسی	/zæmiːnʃiːnɒːsiː/
زمین‌لرزه	/zæmiːne læɾze/
زن	/zæn/
زنی	/zæniː/
زین	/ziːn/
زناشويي	/zænɒːʃuːeiː/
زنانگی	/zænɒːneɡiː/
زن‌بابا	/zænbɒːbɒː/
زنبق	/zæmbæɢ/
زنبور	/zænbuːɾ/
زنبور زدن	/zænbuːɾzædæn/
زنبور عسل	/zænbuːɾe ʔæsæl/
زنبور عسل	/zænbuːɾe æsæl/
زنبورک	/zænbuːɾæk/
زینت	/ziːnæt/
زینت دادن	/ziːnætdɒːdæn/
زنجبیل	/zænd͡ʒebiːl/
زنجیر	/zænd͡ʒiːɾ/
زنجیر زدن	/zænd͡ʒiːɾzædæn/
زنجیر کردن	/zænd͡ʒiːɾkæɾdæn/
زن‌دایی	/zændɒːjiː/
زن دادن	/zændɒːdæn/
زندانی	/zendɒːní/
زندانی کردن	/zendɒːniː kæɾdæn/
زندگی	/zendæɡiː/, /zendeɡiː/
زندگی	/zendeɡiː/
زندگی کردن	/zendeɡiː kæɾdæn/
زندگی کردن	/zendeɡiːkæɾdæn/
زنده	/zendæ/, /zende/
زن‌عمو	/zænæmuː/
زن کثیف	/zæn kæsîf/
زن کردن	/zænkæɾdæn/
زنگ	/zænɡ/
زنگی	/zænɡiː/
زنگبار	/zænɡebɒːɾ/
زنگ خوردن	/zænɡxoɾdæn/
زن گرفتن	/zænɡeɾeftæn/
زنی گرفتن	/zæniːɡeɾeftæn/
زنگ زدن	/zænɡ zædæn/
زنگ زدن	/zænɡzædæn/
زهر	/zæhɾ/
زهرخنده	/zæhɾxænde/
زهرشناسی	/zæhɾʃenɒːsiː/
زوال عقل	/zævɒːle ʔæɢl/
زود	/zuːd/
زور	/zoʊɾ/
زور	/zuːɾ/
زوزه	/zuːze/
زوزه زدن	/zuːzezædæn/
زوزه کشیدن	/zuːzekeʃiːdæn/
زئوس	/zeuːs/
ژاپن	/ʒɒːpon/
ژاپنی	/ʒɒːponiː/
ژاکت	/ʒɒːket/
ژاله	/ʒɒːle/
ژامبون	/ʒɒːmbon/
ژانر	/ʒɒːnɾ/
ژانویه	/ʒɒːnviːje/
ژاویدن	/ʒɒːviːdæn/
ژیرش	/ʒiːɾeʃ/
ژرف	/ʒæɾf/
ژله	/ʒele/
ژنرال	/ʒeneɾɒːl/
ژنو	/ʒenev/
ژنوم	/ʒenom/, /ʒenuːm/
ژوراسیک	/ʒuːɾɒːsiːk/
ژورنال	/ʒoɾnɒːl/
ژوکوف	/ʒuːkov/
ژیوه	/ʒiːve/
ژوئن	/ʒuːʔæn/
ژوئیه	/ʒuːʔiːje/
ژئودزی	/ʒeodeziː/
سی	/siː/
سیا	/siːjɒː/
سایت	/sɒːjt/
ساتراپ	/sɒːtɾɒːp/
سایت زدن	/sɒːjtzædæn/
سیاتل	/sejɒːtæl/
ساتور	/sɒːtuːɾ/
ساحره	/sɒːhæɾe/
ساحل	/sɒːhel/
ساختگی	/sɒːxteɡiː/
ساختمان	/sɒːxtemɒːn/
ساختمون	/sɒːxtemuːn/
ساختن	/sɒːxtæn/
سادگی	/sɒːdeɡiː/
سادگی زدن	/sɒːdeɡiːzædæn/
ساری	/sɒːɾiː/
سارا	/sɒːɾɒː/
سارایوو	/sɒːɾɒːjevo/
سیاره	/sejɒːɾe/
ساروج	/sɒːɾuːd͡ʒ/
ساز	/sɒːz/
سازدهنی	/sɒːzdæhæniː/
سازدهنی زدن	/sɒːzdæhæniːzædæn/
ساز زدن	/sɒːzzædæn/
سازش	/sɒːzeʃ/
سازمان	/sɒːzmɒːn/
سازمان ملل متّحد	/sɒːzmɒːne melæle mottæhed/
سازه	/sɒːzæ/, /sɒːze/
سازواره	/sɒːzvɒːɾe/
ساس	/sɒːs/
سیاست	/siːjɒːsæt/
سیاست‌مدار	/siːjɒːsætmædɒːɾ/
ساعت	/sɒːʔæt/
ساعت	/sɒːæt/
ساعت یک	/sɒːʔæt jek/
ساعت یک و ربع	/sɒːʔæt jek o ɾobʔ/
ساعت یک و نیم	/sɒːʔæt jek o niːm/
ساعد	/sɒːed/
ساق	/sɒːɢ/
ساكت	/sɒːket/
ساکت شدن	/sɒːket ʃodæn/
ساک زدن	/sɒːk zædæn/
ساکسوفون	/sɒːksofon/
ساکورا	/sɒːkuːɾɒː/
سایگون	/sɒːjɡon/
سال	/sɒːl/
سالار	/sɒːlɒːɾ/
سال آینده	/sɒːle ɒːjænde/
سالم	/sɒːlem/
سالن	/sɒːlon/
سال نو	/sɒːl nouː/
سال نوری	/sɒːle nuːɾiː/
سیام	/sjɒːm/
سامانی	/sɒːmɒːniː/
سامانه	/sɒːmɒːne/
سامانه خورشیدی	/sɒːmɒːnexuːɾʃiːdiː/
ساموآ	/sɒːmoɒː/
سانتریفوژ	/sɒːntɾiːfuːʒ/
سانتو دومینگو	/sɒːnto domiːnɡo/
ساندویچ	/sɒːndeviːt͡ʃ/
سان فرانسیسکو	/sɒːn fɾɒːnsiːsko/
سیاه	/siːjɒːh/
سایه	/sɒːje/
سیاه‌چاله	/siːjɒːht͡ʃɒːle/
سیاه‌چاله فضایی	/siːjɒːht͡ʃɒːle fæzɒːjiː/
سیاه خروس	/siːjɒːhe xoɾuːs/
سیاه‌زخم	/siːjɒːhzæxm/
سیاه‌سرفه	/siːjɒːhsoɾfe/
سیاه‌کاج	/siːɒːhkɒːd͡ʒ/
سیاهه	/siːɒːhe/
ساوانا	/sɒːvɒːnɒː/
سایوز	/sɒːjuːz/
سائیگون	/sɒːiːɡon/
سیب	/siːb/
سبد	/sæbæd/
سیبریه	/siːbeɾiːje/
سبز	/sæbz/
سبزی	/sæbziː/
سبزآبی	/sæbzæbiː/
سیب‌زمینی	/siːbzæmiːniː/
سیب‌زمینی سرخ‌کرده	/siːbzæmiːniːje soɾxkæɾde/
سبزینه	/sebziːne/
سبزه	/sæbze/
سبقت	/sebɢæt/
سبقت گرفتن	/sebɢætɡeɾeftæn/
سبک	/sæbok/
سبیل	/sebiːl/
سپاس	/sepɒːs/
سپاسگزار	/sepɒːsɡozɒːɾ/
سپاسگزاری	/sepɒːsɡozɒːɾiː/
سپاسگزارم	/sepɒːsɡozɒːɾæm/
سپتامبر	/septɒːmbɾ/
سپید	/sepiːd/
سپیدار	/sæpiːdɒːɾ/, /sepiːdɒːɾ/
سپر	/sepæɾ/
سپردن	/sepoɾdæn/
سپرز	/sepoɾz/
سپری شدن	/sepæɾiː ʃodæn/
سپس	/sepæs/
سپهر	/sepehɾ/
سپوتنیک	/spuːtniːk/
ست	/set/
ستاد	/setɒːd/
ستادن	/setɒːdæn/
ستارک	/sejɒːɾæk/
ستاره	/setɒːɾe/
ستاره داوود	/setɒːɾeje dævuːd/
ستاره‌ی دریایی	/setɒːɾeje dæɾjɒːjiː/
ستاره دریایی	/siːtɒːɾeje dæɾjɒːjiː/
ستاره سینما	/setɒːɾe je siːnæmɒː/
ستاره سینما	/setɒːɾeje siːnæmɒː/
ستاره‌شناس	/setɒːɾeʃenɒːs/
ستایش	/setɒːjeʃ/
ستخوان	/sotxɒːn/
ستوان	/sotvɒːn/
ستون	/sotuːn/
سیخ	/siːx/
سخت	/sæxt/
سخت‌پوست	/sæxtpuːst/
سیخ زدن	/siːxzædæn/
سیخ‌زن	/siːxzæn/
سیخ کردن	/siːxkæɾdæn/
سیخ کشیدن	/siːxkeʃiːdæn/
سخن	/soxæn/
سخنرانی	/soxænɾɒːniː/
سخن گفتن	/soxænɡoftæn/
سد	/sæd/
سید	/sejjed/
سی‌دی	/siːdiː/
سداب	/sodɒːb/
سد زدن	/sædzædæn/
سد کشیدن	/sædkeʃiːdæn/
سده	/sæde/
سر	/sæɾ/
سر	/seɾ/
سیر	/siːɾ/
سر	/soɾ/
سراب	/sæɾɒːb/
سیرابی	/siːɾɒːbiː/
سراسر	/sæɾɒːsæɾ/
سرآشپز	/sæɾɒːʃpæz/
سراغ	/soɾɒːɢ/
سراغ داشتن	/soɾɒːɢdɒːʃtæn/
سراغ گرفتن	/soɾɒːɢɡeɾeftæn/
سرانجام	/sæɾænd͡ʒɒːm/
سرایوو	/sæɾɒːjevo/
سرب	/soɾb/
سرباز	/sæɾbɒːz/
سرباز نیزه‌دار	/sæɾbɒːze nejzedɒːɾ/
سرجوخه	/sæɾd͡ʒuːxe/
سرچشمه	/sæɾt͡ʃæʃmæ/
سرخ	/soɾx/
سرخابی سیر	/soɾxɒːbiː siːɾ/
سرخس	/sæɾæxs/
سرخک	/soɾxæk/
سرخواجه	/sæɾxɒːd͡ʒe/
سر خوردن	/soɾxoɾdæn/
سرد	/sæɾd/
سرداب	/sæɾdɒːb/
سردابه	/sæɾdɒːbe/
سر دادن	/soɾdɒːdæn/
سردبیر	/sæɾdæbiːɾ/
سر درآوردن	/sæɾdæɾɒːvæɾdæn/
سردرد	/sæɾdæɾd/
سرده	/sæɾde/
سریر	/sæɾiːɾ/
سر رفتن	/sæɾɾæftæn/
سر زدن	/sæɾzædæn/
سرزمین	/sæɾzæmiːn/
سر سخت	/sæɾ sæxt/
سرسرا	/sæɾsæɾɒː/
سرشاخه	/sæɾʃɒːxe/
سرشیر	/sæɾʃiːɾ/
سرطان	/sæɾætɒːn/
سرعت	/soɾʔæt/
سرعت گری	/soɾʔɒːt ɡɒːɾiː/
سرعت نور	/soɾʔæte nuːɾ/
سرفیدن	/soɾfiːdæn/
سرفه	/soɾfe/
سرفه افتادن	/soɾfeoftɒːdæn/
سرفه انداختن	/soɾfeændɒːxtæn/
سرفه کردن	/soɾfe kæɾdæn/
سرفه کردن	/soɾfekæɾdæn/
سرفه گرفتن	/soɾfeɡeɾeftæn/
سرک	/sæɾæk/
سیرک	/siːɾk/
سر کیر	/sæɾe kiːɾ/
سرکرده	/sæɾkæɾde/
سرکش	/sæɾkeʃ/
سر کشیدن	/sæɾkeʃiːdæn/
سرک کشیدن	/sæɾækkeʃiːdæn/
سرکه	/seɾke/
سیر کوب	/sîɾkob/
سرکوفت	/sæɾkuːft/
سرکوفت خوردن	/sæɾkuːftxoɾdæn/
سرکوفت زدن	/sæɾkuːftzædæn/
سر گرفتن	/sæɾɡeɾeftæn/
سرگرمی	/sæɾɡæɾmiː/
سری‌لانکا	/sɾiːlɒːnkɒː/
سیریلیک	/siːɾiːliːk/
سریم	/seɾiːom/
سرم	/seɾom/
سرما	/sæɾmɒː/
سرماخوردگی	/sæɾmɒːxoɾdeɡiː/
سرماخوردگی زدن	/sæɾmɒːxoɾdeɡiːzædæn/
سرما خوردن	/sæɾmɒːxoɾdæn/
سرما زدن	/sæɾmɒːzædæn/
سرمایه‌گذاری	/sæɾmɒːjeɡozɒːɾiː/
سرمایه‌گذاری کردن	/sæɾmɒːjeɡozɒːɾiːkæɾdæn/
سرم زدن	/seɾomzædæn/
سرمه	/soɾme/
سرمه‌ای	/soɾmejiː/
سرنا	/soɾnɒː/
سرنای	/soɾnɒːj/
سرنیزه	/sæɾnejze/
سرهنگ	/sæɾhænɡ/
سرو	/sæɾv/
سرود ملی	/suːɾuːde melliː/
سرودن	/soɾuːdæn/
سرور	/sæɾvæɾ/
سرور	/soɾuːɾ/
سرویس	/seɾviːs/
سرویس زدن	/seɾviːszædæn/
سیزده	/siːzdæh/
سزیم	/seziːom/
سس	/sos/
سیستم	/siːstem/
سیسیل	/siːsiːl/
سیسیلی	/siːsiːliː/
سیصد	/siːsæd/
سطح	/sætæh/
سعی	/sæʔj/
سعی داشتن	/sæʔjdɒːʃtæn/
سعی کردن	/sæʔjkæɾdæn/
سفارت	/sefɒːɾæt/
سفارتخانه	/sefɒːɾæt xɒːne/
سفارش	/sefɒːɾeʃ/
سفارش دادن	/sefɒːɾeʃ dɒːdæn/
سفارش دادن	/sefɒːɾeʃdɒːdæn/
سفارش کردن	/sefɒːɾeʃkæɾdæn/
سفت	/seft/
سفتر	/seftæːɾ/
سفید	/sefiːd/
سفیدار	/sæfiːdɒːɾ/, /sefiːdɒːɾ/
سفر	/sæfæɾ/
سفیر	/sefiːɾ/
سفر به خير	/sæfæɾ be xeiːɾ/
سفر خوش	/sæfæɾ xoʃ/
سفر کردن	/sæfæɾ kæɾdæn/
سفر کردن	/sæfæɾkæɾdæn/
سقرلات	/sæɢeɾlɒːt/
سقیط	/sæɢiːt/
سقط	/seɢt/
سقط کردن	/seɢtkæɾdæn/
سقف	/sæɢf/
سقلمه	/soɢolme/
سقلمه زدن	/soɢolmezædæn/
سقوط	/soɢuːt/
سقوط کردن	/soɢuːtkæɾdæn/
سكوت	/sokuːt/
سكوت کردن	/sokuːtkæɾdæn/
سیکتیوکار	/siːktiːvkɒːɾ/
سکس دهنی	/sekse dæhæniː/
سکس مقعدی	/sekse mæɢʔædiː/
سکندر کبیر	/eskændæɾ kæbiːɾ/
سکه	/sekke/
سکوت	/sokuːt/
سکون	/sokuːn/
سگ	/sæɡ/
سگ آبی	/sæɡe ɒːbiː/
سیگارت	/siːɡɒːɾet/
سیگار‌فروش	/siːɡɒːɾfoɾuːʃ/
سگدو	/sæɡdo/
سگدو زدن	/sæɡdozædæn/
سیگما	/siːɡmɒː/
سیل	/sæiːl/
سل	/sell/
سیلی	/siːliː/
سلاح	/selɒːh/
سلاح هسته‌ای	/selɒːhe hæsteʔiː/
سلام	/sælɒːm/
سلامت	/sælɒːmæt/
سلام دادن	/sælɒːmdɒːdæn/
سلام دنیا	/sælɒːm donjɒː/
سلام علیکم	/sælɒːmo ælejkom/
سیلی خوردن	/siːliːxoɾdæn/
سیلی زدن	/siːliːzædæn/
سلطان	/soltɒːn/
سلطنت	/sæltænæt/
سلما	/sælmɒː/
سیم	/siːm/
سیما	/siːmɒː/
سمارا	/sɒːmɒːɾɒː/
سمارت‌ فون	/smɒːɾt fon/
سماق	/somɒːɢ/
سیمان	/siːmɒːn/
سماور	/sæmɒːvæɾ/
ﺱیﺲﺘﻣ ﻉﺎﻤﻟ	/siːstem ɒːmæl/
سیمرغ	/siːmoɾɢ/
سمرقند	/sæmæɾɢænd/
سمفونی	/semfuːniː/, /siːmfuːniː/
سیمین	/siːmiːn/
سمور	/sæmuːɾ/
سن	/senn/
سینی	/siːniː/
سنا	/senɒː/
سنباده	/sombɒːde/
سنباده خوردن	/sombɒːdexoɾdæn/
سنباده زدن	/sombɒːdezædæn/
سنباده کشیدن	/sombɒːdekeʃiːdæn/
سنبل	/sombol/
سن پترزبورگ	/sæn peteɾzbuːɾɡ/
سنت	/sonnæt/
سنجاب	/sænd͡ʒɒːb/
سنجاق	/sænd͡ʒɒːɢ/
سنجاق زدن	/sænd͡ʒɒːɢzædæn/
سنجاقک	/sænd͡ʒɒːɢæk/
سنجش	/sænd͡ʒeʃ/
سنجه	/sænd͡ʒe/
سند	/sænæd/
سند	/send/
سندی	/sendiː/
سندیکا	/sendiːkɒː/
سنقر	/sonɢoɾ/
سنگ	/sænɡ/
سنگاپور	/senɡɒːpuːɾ/
سنگال	/seneɡɒːl/
سنگ آهک	/sænɡ ɒːhæk/
سنگ جادو	/sænɡe d͡ʒɒːduː/
سنگر	/sænɡæɾ/
سنگ رشید	/sænɡe ɾæʃiːd/
سنگ زدن	/sænɡzædæn/
سنگسار	/sænɡsɒːɾ/
سنگین	/sænɡiːn/
سنگینی	/sænɡiːniː/
سینما	/siːnemɒː/
سینه	/siːne/
سینه زدن	/siːnezædæn/
سه	/se/
سه‌تار	/setɒːɾ/
سه‌چهارم‌خط	/set͡ʃæhɒːɾomxæt/
سه‌شنبه	/seʃænbe/
سه‌گوش	/seɡuːʃ/
سهل	/sæhl/
سه نفری	/se næfæɾiː/
سه‌نقطه	/senoɢte/
سویا	/sojɒː/
سواحیلی	/swɒːhiːliː/
سواری کردن	/sævɒːɾiː kæɾdæn/
سؤال	/soʔɒːl/
سوپ	/suːp/
سوپرمارکت	/suːpeɾmɒːɾket/
سوت	/suːt/
سوت زدن	/suːtzædæn/
سوت کشیدن	/suːtkeʃiːdæn/
سوچی	/sot͡ʃiː/
سوختن	/suːxtæn/
سود	/suːd/
سودان	/suːdɒːn/
سودان جنوبی	/suːdɒːne d͡ʒænuːbiː/
سود سهام	/suːde sæhɒːm/
سودمند	/suːdmænd/
سورابایا	/suːɾɒːbɒːjɒː/
سوراخ	/suːɾɒːx/
سوراخ کس	/suːɾɒːxe kos/
سوراخ کون	/suːɾɒːxe kuːn/
سورانی	/soɾɒːniː/
سورپرایز	/suːɾpeɾɒːjz/
سورنای	/suːɾnɒːj/
سورینام	/suːɾiːnɒːm/
سوره	/suːɾe/
سوریه	/suːɾiːje/
سوزن	/suːzæn/
سوزن ته‌گرد	/suːzæne tæhɡeɾd/
سوزن زدن	/suːzænzædæn/
سوزن منگنه	/suːzæne mænɡæne/
سوزوکی	/suːzuːkiː/
سویس	/suːviːs/
سوسیالیست	/sosiːjɒːliːst/
سوسیالیستی	/sosiːjɒːliːstiː/
سوسیالیسم	/sosjɒːliːsm/
سوسیس	/sosiːs/
سوسک	/suːsk/
سوسمار	/suːsmɒːɾ/
سوسن	/souːsæn/
سوسو	/suːsuː/
سوسو زدن	/suːsuːzædæn/
سوفیه	/sofiːje/
سوم	/som/
سومالی	/suːmɒːliː/
سونامی	/suːnɒːmiː/
سوهان	/soʊhɒːn/
سوهان زدن	/sohɒːnzædæn/
سوهان کردن	/sohɒːnkæɾdæn/
سوئد	/suːʔed/
سوئز	/suːez/
سوئیس	/suːʔiːs/
سئول	/seʔuːl/
سياه	/siːɒːh/
سياه	/siːjɒːh/
سيمگون	/siːmɡuːn/
شی	/ʃiː/
شیء	/ʃejʔ/
شاتل فضایی	/ʃɒːtele fæzɒːjiː/
شاتوت	/ʃɒːtuːt/
شاخ	/ʃɒːx/
شاخاب	/ʃɒːxɒːb/
شاخاب پارس	/ʃɒːxɒːbe pɒːɾs/
شاخ آفریقا	/ʃɒːxe æfɾiːɢɒː/
شاخ زدن	/ʃɒːxzædæn/
شاخص	/ʃɒːxes/
شاخه	/ʃɒːxe/
شادی	/ʃɒːdiː/
شاید	/ʃɒːjæd/
شاد	/ŝɒːd/
شادکام	/ʃɒːdkɒːm/
شاذ	/ʃɒːzz/
شیار	/ʃiːɒːɾ/
شیار زدن	/ʃiːɒːɾzædæn/
شاش	/ʃɒːʃ/
شاشیدن	/ʃɒːʃiːdæn/
شایع	/ʃɒːjeʔ/
شال	/ʃɒːl/
شالیزار	/ʃɒːliːzɒːɾ/
شالوده	/ʃɒːluːdæ/
شالوم	/ʃɒːluːm/, /ʃɒːlom/
شام	/ʃɒːm/
شامپاین	/ʃɒːmpɒːiːn/
شامپو	/ʃæmpuː/
شامپو	/ʃɒːmpuː/
شامپو زدن	/ʃæmpuːzædæn/
شامپو کردن	/ʃæmpuːkæɾdæn/
شامگاه	/ʃɒːmɡɒːh/
شامل کردن	/ʃɒːmel kæɾdæn/
شامه	/ʃɒːmme/
شانزده	/ʃɒːnzdæh/
شانگهای	/ʃɒːnɡhɒːiː/
شانه	/ʃɒːne/
شانه زدن	/ʃɒːnezædæn/
شانه کردن	/ʃɒːne kæɾdæn/
شانه کردن	/ʃɒːnekæɾdæn/
شانه کشیدن	/ʃɒːnekeʃiːdæn/
شاه	/ʃɒːh/
شاه‌اثر	/ʃɒːhæsæɾ/
شاه‌بلوط	/ʃɒːhbæluːt/
شاه‌توت	/ʃɒːhtuːt/
شاهد	/ʃɒːhed/
شاه‌دانه	/ʃɒːhdɒːne/
شاهدخت	/ʃɒːhdoxt/
شاهزاده	/ʃɒːhzɒːde/
شاهزاده‌خانم	/ʃɒːhzɒːdexɒːnom/
شاهکار	/ʃɒːhkɒːɾ/
شاه مات	/ʃɒːh mɒːt/
شاهین	/ʃɒːhiːn/
شاهنشاهی	/ʃɒːhænʃɒːhiː/
شاهنشاهی ایران	/ʃɒːhænʃɒːhiːje iːɾɒːn/
شاهوار	/ʃɒːhvɒːɾ/
شب	/ʃæb/
شبان	/ʃobɒːn/, /ʃæbɒːn/
شبانه	/ʃæbɒːne/
شبح	/ʃæbæh/
شبیخون	/ʃæbiːxuːn/
شبیخون زدن	/ʃæbiːxuːnzædæn/
شبکیه	/ʃæbækiːje/
شبنم	/ʃæbnæm/
شبنم زدن	/ʃæbnæmzædæn/
شبیه	/ʃæbiːh/
شبه‌جزیره	/ʃebed͡ʒæziːɾe/
شپش	/ʃepeʃ/
شیپور	/ʃejpuːɾ/
شیپور زدن	/ʃejpuːɾzædæn/
شتر	/ʃotoɾ/
شتر بیکوهان	/ʃotoɾe biːkohɒːn/
شترگاوپلنگ	/ʃotoɾɡɒːvpælænɡ/
شترمرغ	/ʃotoɾ moɾɢ/
شترمرغ	/ʃotoɾmoɾɢ/
شتک	/ʃætæk/
شتک زدن	/ʃætækzædæn/
شجاع	/ʃod͡ʒɒːʔ/
شجر	/ʃæd͡ʒæɾ/
شیخ	/ʃejx/
شخص	/ʃæxs/
شخم	/ʃoxm/
شخم خوردن	/ʃoxmxoɾdæn/
شخم زدن	/ʃoxmzædæn/
شخم کردن	/ʃoxmkæɾdæn/
شدت	/ʃeddæt/
شدت گرفتن	/ʃeddætɡeɾeftæn/
شدن	/ʃodæn/
شیر	/ʃiːɾ/
شیری	/ʃiːɾiː/
شراب	/ʃæɾɒːb/
شرابی	/ʃæɾɒːbiː/
شیراز	/ʃiːɾɒːz/
شربت	/ʃæɾbæt/
شیرجه	/ʃiːɾd͡ʒe/
شیرجه زدن	/ʃiːɾd͡ʒezædæn/
شیر دادن	/ʃiːɾdɒːdæn/
شیردال	/ʃiːɾdɒːl/
شیردل	/ʃiːɾdel/
شرط	/ʃæɾt/
شیرفروش	/ʃiːɾfoɾuːʃ/
شرق	/ʃæɾɢ/
شرقی	/ʃæɾɢiː/
شرق تیمور	/ʃæɾɢe tiːmoɾ/
شریک	/ʃæɾiːk/
شرکت	/ʃeɾkæt/
شرکت کردن	/ʃeɾkætkæɾdæn/
شرکت هواپیمایی	/ʃeɾkæte hævɒːpejmɒːjiː/
شیر کوهی	/ʃiːɾe kuːhiː/
شیرگاه	/ʃiːɾɡɒːh/
شرم	/ʃæɾm/
شیرین	/ʃiːɾiːn/
شیرین کردن	/ʃiːɾiːn kæɾdæn/
شروع	/ʃoɾuːʔ/
شروع کردن	/ʃoɾuːʔ kæɾdæn/
شروع کردن	/ʃoɾuːʔkæɾdæn/
شست	/ʃæst/
شستی	/ŝæstiː/
شستشو	/ʃosteʃuː/
شستشو دادن	/ʃosteʃuːdɒːdæn/
شستن	/ʃostæn/
شش	/ʃeʃ/
شش	/ʃoʃ/
ششصد	/ʃeʃsæd/
ششم	/ʃeʃom/
شیشه	/ʃiːʃe/
شصت	/ʃæst/
شصت و نه	/ʃæst o noh/
شیطان	/ʃejtɒːn/
شیطان بزرگ	/ʃejtɒːne bozoɾɡ/
شطرنج	/ʃætɾænd͡ʒ/
شطرنج زدن	/ʃætɾænd͡ʒzædæn/
شیعی	/ʃiːʔiː/
شعاع	/ʃoʔɒːʔ/
شعر	/ʃʔeɾ/
شعله	/ʃo’le/
شعله	/ʃoʔle/
شعله زدن	/ʃo’lezædæn/
شعله کشیدن	/ʃo’lekeʃiːdæn/
شیعه	/ʃiːʔe/
شغال	/ʃoɢɒːl/
شغل	/ʃoɢl/
شفا	/ʃæfɒː/
شفا دادن	/ʃæfɒːdɒːdæn/
شفتالو	/ʃæftɒːluː/
شیفتگی	/ʃiːftæɡiː/, /ʃiːfteɡiː/
شق کردن	/ʃæɢ kæɾdæn/
شک	/ʃæk/
شکار	/ʃekɒːɾ/
شکارچی	/ʃekɒːɾt͡ʃiː/
شکار کردن	/ʃekɒːɾ kæɾdæn/
شیکاگو	/ʃiːkɒːɡo/
شکر	/ʃekæɾ/
شکر	/ʃekæɾ/, /ʃækæɾ/, /ʃækkæɾ/
شکری	/ʃekæɾiː/
شکر	/ʃokɾ/
شکرک	/ʃekæɾæk/
شکر کردن	/ʃokɾkæɾdæn/
شکرک زدن	/ʃekæɾækzædæn/
شکست دادن	/ʃekæst dɒːdæn/
شکستن	/ʃekæstæn/
شکفتن	/ʃekoftæn/
شک کردن	/ʃækkæɾdæn/
شکل	/ʃækl/
شکلاتی	/ʃokolɒːtiː/
شکلات داغ	/ʃokolɒːte dɒːɢ/
شکلک	/ʃeklæk/
شکم	/ʃekæm/
شکمبند	/ʃekæmbænd/
شکمبه	/ʃekæmbe/
شکم دریدن	/ʃekæm dæɾiːdæn/
شکنجه	/ʃekænd͡ʒe/
شکنجه دادن	/ʃekænd͡ʒedɒːdæn/
شکوفه	/ʃokuːfe/
شکوفه زدن	/ʃokuːfezædæn/
شکوفه کردن	/ʃokuːfekæɾdæn/
شکوه	/ʃokuːh/
شگرد	/ʃeɡeɾd/
شگرد زدن	/ʃeɡeɾdzædæn/
شگرف	/ʃeɡæɾf/
شگفت	/ʃeɡæft/
شل	/ʃæl/
شیلی	/ʃiːliː/
شلاق	/ʃællɒːɢ/
شلاق خوردن	/ʃællɒːɢxoɾdæn/
شلاق زدن	/ʃællɒːɢzædæn/
شیلر	/ʃiːleɾ/
شل زدن	/ʃælzædæn/
شلغم	/ʃælɢæm/
شلیک	/ʃeliːk/
شلیک کردن	/ʃeliːkkæɾdæn/
شلیک کردن	/ʃelliːk kæɾdæn/
شلیل	/ʃæliːl/
شلیل.شبرنگ	/ʃæliːl.ʃæbɾænɡ/
شلوار	/ʃælvɒːɾ/
شلوغ	/ʃoluːɢ/
شیمی	/ʃiːmiː/
یشمی	/jæʃmiː/
شما	/ʃomɒː/
شمار	/ʃomɒːɾ/
شما را	/ʃomɒː ɾɒː/
شم ارا	/ʃomɒːɾɒː/
شمار آمدن	/ʃomɒːɾɒːmædæn/
شمار آوردن	/ʃomɒːɾɒːvæɾdæn/
شمارشگر	/ʃomɒːɾeʃɡæɾ/
شماره	/ʃomɒːɾe/
شماره تلفن	/ʃomɒːɾeje telefon/
شماره‌گذاری	/ʃomɒːɾeɡozɒːɾiː/
شماره‌گذاری شدن	/ʃomɒːɾeɡozɒːɾiːʃodæn/
شماره‌گذاری کردن	/ʃomɒːɾeɡozɒːɾiːkæɾdæn/
شماره گرفتن	/ʃomɒːɾeɡeɾeftæn/
شمال	/ʃæmɒːl/, /ʃemɒːl/, /ʃomɒːl/
شمال	/ʃomɒːl/
شمال شرقی	/ʃæmɒːle ʃæɾɢiː/
شمال شرقی	/ʃomɒːle ʃæɾɢiː/
شمال غربی	/ʃæmɒːle ɢæɾbiː/
شمال غربی	/ʃomɒːle ɢæɾbiː/
شمالگان	/ʃomæleɡɒːn/
شمپانزه	/ʃæmpɒːnze/
شمردن	/ʃemoɾdæn/
شمردن	/ʃomoɾdæn/
شمس	/ʃæms/
شمشیر	/ʃæmʃiːɾ/
شمشیرزن	/ʃæmʃiːɾzæn/
شمشیرماهی	/ʃæmʃiːɾmɒːhiː/
شمع	/ʃæmʔ/
شمعدان	/ʃæmʔædɒːn/
شیمیل	/ʃiːmejl/
شیمی هسته‌ای	/ʃiːmiːje hæsteʔiː/
شن	/ʃen/
شناخت	/ʃenɒːxt/
شناختن	/ʃenɒːxtæn/
شناریدن	/ʃenɒːɾiːdæn/
شناس	/ʃenɒːs/
شناسایی	/ʃenɒːsɒːjiː/
شنا کردن	/ʃenɒː kæɾdæn/
شناگر	/ʃenɒːɡæɾ/
شناویدن	/ʃenɒːviːdæn/
شناوری کردن	/ʃenɒːvæɾiː kæɾdæn/
شنبلیله	/ʃænbeliːle/
شنبه	/ʃænbe/
شنیدن	/ʃeniːdæn/
شن‌کش	/ʃenkeʃ/
شنگرف	/ʃænɡæɾf/
شهادت	/ʃæhɒːdæt/
شهادت دادن	/ʃæhɒːdætdɒːdæn/
شهامت	/ʃæhɒːmæt/
شهباز	/ʃæhbɒːz/
شهبانو	/ʃæhbɒːnuː/
شهد	/ʃæhd/
شهید	/ʃæhiːd/
شهر	/ʃæhɾ/
شهری	/ʃæhɾiː/
شهرآورد	/ʃæhɾɒːvæɾd/
شهرت	/ʃæhɾæt/
شهردار	/ʃæhɾdɒːɾ/
شهرزاد	/ʃæhɾzɒːd/
شهر فرنگ	/ʃæhɾe fæɾænɡ/
شهرک	/ʃæhɾæk/
شهر مراکش	/ʃæhɾ mæɾɒːkeʃ/
شهریور	/ʃæhɾiːvæɾ/
شهسوار	/ʃæhsævɒːɾ/
شهمات	/ʃɒːhmɒːt/
شهمات کردن	/ʃæhmɒːt kæɾdæn/
شهنگانه	/ʃæhænɡɒːne/
شیهه	/ʃejhe/
شیهه زدن	/ʃejhezædæn/
شیهه کشیدن	/ʃejhekeʃiːdæn/
شهوتی	/ʃæhvætiː/
شو	/ʃuː/
شوی	/ʃuːj/
شوارزنگر	/ʃvɒːɾzeneɡeɾ/
شوالیه	/ʃovɒːliːje/
شوالیه كردن	/ʃovɒːlje kæɾdæn/
شوان	/ʃovɒːn/, /ʃævɒːn/
شوپرک	/ʃoʊpæɾæk/
شوت	/ʃuːt/
شوت زدن	/ʃuːtzædæn/
شوخی	/ʃuːxiː/
شوخی کردن	/ʃuːxiːkæɾdæn/
شوید	/ʃeviːd/
شوریدن	/ʃuːɾiːdæn/
شورش	/ʃuːɾeʃ/
شورشی	/ʃuːɾeʃiː/
شورش کردن	/ʃuːɾeʃkæɾdæn/
شورش‌ها	/ʃuːɾeʃhɒː/
شوروی	/ʃuːɾæviː/
شوش	/ʃuːʃ/
شوفان	/ʃuːfɒːn/
شوکولات	/ʃuːkuːlɒːt/
شوم	/ʃuːm/
شیون	/ʃiːvæn/
شیون زدن	/ʃiːvænzædæn/
شیون کردن	/ʃiːvænkæɾdæn/
شیون کشیدن	/ʃiːvænkeʃiːdæn/
شیوه	/ʃiːve/
شوهر	/ʃoʊhæɾ/
شوهرخاله	/ʃoʊhæɾxɒːle/
شوهر دادن	/ʃohæɾdɒːdæn/
شوهر	/شوهر/
شوهرعمه	/ʃoʊhæɾæmme/
شوهر کردن	/ʃohæɾkæɾdæn/
شوونیسم	/ʃouːvæniːsm/
صابون	/sɒːbuːn/
صابون زدن	/sɒːbuːnzædæn/
صاحبخانه	/sɒːhebxɒːne/
صاریغ	/sɒːɾiːɢ/
صاعقه	/sɒːʔeɢe/
صاعقه	/sɒːeɢe/
صافی	/sɒːfiː/
صبح	/sobh/
صبحانه	/sobhɒːne/
صبح بخیر	/sobh bexejɾ/
صبح زود	/sobhe zuːd/
صبر	/sæbɾ/
صبر کردن	/sæbɾ kæɾdæn/
صبر کردن	/sæbɾkæɾdæn/
صبور	/sæbuːɾ/
صحبت	/sohbæt/
صحبت کردن	/sohbæt kæɾdæn/
صحبت کردن	/sohbætkæɾdæn/
صحت	/sehæt/
صحیح	/sæhiːh/
صحرا	/sæhɾɒː/
صحرای غربی	/sæhɒːɾæ ɢæɾbiː/
صحنه	/sæhne/
صحنه رقص	/sæhneje ɾæɢs/
صد	/sæd/
صید	/sæiːd/
صدا	/sedɒː/
صدا دادن	/sedɒː dɒːdæn/
صدا زدن	/sedɒː zædæn/
صدا زدن	/sedɒːzædæn/
صدا کردن	/sedɒːkæɾdæn/
صدام	/sæddɒːm/
صدپا	/sædpɒː/
صدف	/sædæf/
صید کردن	/sæiːd kæɾdæn/
صدمه	/sædæme/
صدمه خوردن	/sædæmexoɾdæn/
صدمه دیدن	/sædæmediːdæn/
صدمه زدن	/sædæmezædæn/
صربی	/sæɾbiː/
صربی	/seɾbiː/
صربستانی	/sæɾbiːstɒːniː/
صربستان	/seɾbestɒːn/
صربستانی	/seɾbiːstɒːniː/
صربستان و مونته‌نگرو	/ṣeɾbestɒːn uː muːnteneɡɾuː/
صرع	/sæɾ/
صعب	/sæʔb/
صف	/sæf/
صفت	/sefæt/
صفت برتر	/sefæte bæɾtæɾ/
صفت برترین	/sefæte bæɾtæɾiːn/
صفحه	/sæfhe/
صفحه آبی مرگ	/sæfheje ɒːbiːje mæɾɡ/
صفحه اصلی	/sæfheje æsliː/
صفحه خانگی	/sæfheje xɒːneɡiː/
صفحه کلید	/sæfhekeliːd/
صفر	/sefɾ/
صف کشیدن	/sæfkeʃiːdæn/
صیقل زدن	/sejɢæl zædæn/
صقلیه	/seɢliːje/
صلیب	/sæliːb/
صلیب سرخ	/sæliːbe soɾx/
صلح	/solh/
صلح کردن	/solhkæɾdæn/
صندل	/sændæl/
صندلی	/sændæliː/
صندلی راحتی‏	/sændæliː ɾɒːhætiː/
صندوق	/sænduːɢ/
صندوق پست	/sonduːɢe post/
صهیونیسم	/sæhjuːniːsm/
صوری	/suːɾiː/
صورتی	/soɾætiː/
صورت	/suːɾæt/
صورتی	/suːɾætiː/
صورت دادن	/suːɾætdɒːdæn/
صورت گرفتن	/suːɾætɡeɾeftæn/
صوفیا	/sofiːjɒː/
صوفیه	/sofiːje/
ضجه	/zæd͡ʒd͡ʒe/
ضجه زدن	/zæd͡ʒd͡ʒezædæn/
ضجه کردن	/zæd͡ʒd͡ʒekæɾdæn/
ضجه کشیدن	/zæd͡ʒd͡ʒekeʃiːdæn/
ضخیم	/zæxiːm/
ضرب	/zæɾb/
ضربت	/zæɾbæt/
ضربت خوردن	/zæɾbætxoɾdæn/
ضربت زدن	/zæɾbætzædæn/
ضربدر	/zæɾbdæɾ/
ضربدر زدن	/zæɾbdæɾzædæn/
ضرب گرفتن	/zæɾbɡeɾeftæn/
ضربه	/zæɾbe/
ضربه خوردن	/zæɾbexoɾdæn/
ضربه زدن	/zæɾbezædæn/
ضرر	/zæɾæɾ/
ضرر خوردن	/zæɾæɾxoɾdæn/
ضرر زدن	/zæɾæɾzædæn/
ضرر کردن	/zæɾæɾkæɾdæn/
ضروری	/zæɾuːɾiː/
ضرورت	/zæɾuːɾæt/
ضعیف	/zæʔiːf/
ضمانت	/zemɒːnæt/
ضمیر	/zæmiːɾ/
ضمیمه	/zæmiːme/
ضمنی	/zemniː/
ضمه	/zæmme/
طیاره	/tejjɒːɾe/
طاس	/tɒːs/
طاعون	/tɒːʔuːn/
طالبی	/tɒːlebiː/
طاووس	/tɒːvuːs/
طاووس هندی	/tɒːvuːse hendiː/
طب	/tebb/
طبیب	/tæbiːb/
طب سوزنی	/tebbe suːzæniː/
طبیعت	/tæbiːjʔæt/
طبیعتاّ	/tæbiːætæn/
طبق معمول	/tebɢe mæʔmuːl/
طبقه	/tæbæɢe/
طبقه کارگر	/tæbæɢeje kɒːɾɡæɾ/
طبل	/tæbl/
طحال	/tæhɒːl/
طرابلس	/tæɾɒːbolos/
طراح	/tæɾɒːh/
طراحی	/tæɾɾɒːhiː/
طرح	/tæɾh/
طرح زدن	/tæɾhzædæn/
طرح کشیدن	/tæɾhkeʃiːdæn/
طرز فکر	/tæɾzefekɾ/
طرف	/tæɾæf/
طرفدار	/tæɾæfdɒːɾ/
طرف گرفتن	/tæɾæfɡeɾeftæn/
طریقه	/tæɾiːɢe/
طعم	/tæʔm/
طعنه	/tæʔne/
طعنه زدن	/tæʔnezædæn/
طغیان	/toɢjɒːn/
طغیان کردن	/toɢjɒːnkæɾdæn/
طفره	/tæfɾe/
طفره رفتن	/tæfɾeɾæftæn/
طفل	/tefl/
طلا	/tælɒː/
طلایی	/tælɒːjiː/
طلاق	/tælɒːɢ/
طلب کردن	/tælæb kæɾdæn/
طلوع	/toluːʔ/
طلوع کردن	/toluːʔkæɾdæn/
طناب	/tænɒːb/
طهران	/tehɾɒːn/
طوطی	/tuːtiː/
طوفان	/tuːfɒːn/
طوفان ریگ	/tuːfɒːne ɾiːɡ/
طول	/tuːl/
طولانی	/tuːlɒːniː/
طول موج	/tuːle moʊd͡ʒ/
طومار	/tuːmɒːɾ/
ظالم	/zɒːlem/
ظرف	/zæɾf/
ظفر	/zæfæɾ/
ظهر	/zohɾ/
ظهر بخیر	/zohɾ bexejɾ/
ظهور	/zohuːɾ/
ظهور کردن	/zohuːɾkæɾdæn/
عابر بانک	/ʔɒːbeɾ bɒːnk/
عاج	/ʔɒːd͡ʒ/
عادی	/ʔɒːdiː/
عادت	/ʔɒːdæt/
عادت	/ɒːdæt/
عادت دادن	/ɒːdætdɒːdæn/
عادت کردن	/ɒːdætkæɾdæn/
عادت گرفتن	/ɒːdætɡeɾeftæn/
عاریت	/ɒːɾjæt/
عاریت گرفتن	/ɒːɾjætɡeɾeftæn/
عاریه	/ɒːɾje/
عاریه گرفتن	/ɒːɾjeɡeɾeftæn/
عاريه	/ɒːɾiːje/
عاشق	/ʔɒːʃeɢ/
عاشق بودن	/ʔɒːʃeɢ buːdæn/
عاشق شدن	/ɒːʃeɢ ʃodæn/
عافیت باشه	/ɒːfiːjæt bɒːʃe/
عالی	/ʔɒːliː/
عالم	/ʔɒːlæm/
عالم	/ʔɒːlem/
عائله	/ʔɒːʔiːle/
عبادت کردن	/ʔebɒːdæt kæɾdæn/
عبارت باقاعده	/ʔebɒːɾæte bɒːɢɒːʔede/
عیبجویی کردن	/ʔejbd͡ʒuːjiː kæɾdæn/
عبری	/ebɾiː/
عبرانی	/ebɾɒːniː/
عجان	/ʔed͡ʒɒːn/
عجیب	/ʔæd͡ʒiːb/
عجیب و غریب	/ʔæd͡ʒiːb o ɢæɾiːb/
عجیب و غریب	/ʔæd͡ʒiːboɢæɾiːb/
عجله	/æd͡ʒæle/
عجله کار شیطان است	/æd͡ʒæle kɒːɾe ʃejtɒːn æst/
عجله کردن	/æd͡ʒælekæɾdæn/
عید پاک	/ejde pɒːk/
عدد	/ʔædæd/
عدد صحیح	/ædæde sæhiːh/
عدس	/ʔædæs/
عدس	/ædæs/
عدسی	/ædæsiː/
عدسی	/æddæsiː/
عید قربان	/eiːde ɢoɾbɒːn/
عدل	/ædl/
عذاب	/æzɒːb/
عذاب آمدن	/æzɒːbɒːmædæn/
عذاب دادن	/æzɒːbdɒːdæn/
عذاب کشیدن	/æzɒːbkeʃiːdæn/
عذرخواهی	/ozɾxɒːhiː/
عذرخواهی کردن	/ozɾxɒːhiːkæɾdæn/
عر	/æɾ/
عراق	/ʔeɾɒːɢ/
عراقی	/ʔeɾɒːɢiː/
عرب	/ʔæɾæb/
عربی	/ʔæɾæbiː/
عربی	/æɾæbiː/
عربده	/æɾbæde/
عربده زدن	/æɾbædezædæn/
عربده کشیدن	/æɾbædekeʃiːdæn/
عربستان	/æɾæbestɒːn/
عربستان سعودی	/ʔæɾebiːstɒːne sæʔuːdiː/
عربی مصری	/ʔæɾæbiː mesɾiː/
عر زدن	/æɾzædæn/
عرش	/ʔæɾʃ/
عرف	/oɾf/
عرفانی	/eɾfɒːniː/
عرق	/ʔæɾæɢ/
عرق	/æɾæɢ/
عرق ریختن	/æɾæɢɾiːxtæn/
عرق کردن	/æɾæɢkæɾdæn/
عر کشیدن	/æɾkeʃiːdæn/
عروس	/æɾuːs/
عروسی	/ʔæɾuːsiː/
عروسی	/æɾuːsiː/
عروس دریایی	/oɾuːs dæɾjɒːjiː/
عروسک	/ʔæɾuːsæk/
عروسی کردن	/æɾuːsiːkæɾdæn/
عروسی گرفتن	/æɾuːsiːɡeɾeftæn/
عزا	/æzɒː/
عزا گرفتن	/æzɒːɡeɾeftæn/
عزیز	/ʔæziːz/
عزیز	/æziːz/
عزم	/ʔæsm/
عزم	/æzm/
عزم داشتن	/æzmdɒːʃtæn/
عیسی	/ʔiːsɒː/
عسل	/æsæl/
عیسی مسیح	/ʔiːsɒː mæsiːh/
عشق	/ʔeʃɢ/
عشق‌آباد	/eʃɢ ɒːbɒːd/
عشق‌بازی	/eʃɢbɒːziː/
عشق داشتن	/ʔeʃɢ dɒːʃtæn/
عصا	/æsɒː/
عصا زدن	/æsɒːzædæn/
عصب	/ʔæsæb/
عصب	/æsæb/
عصبانی	/æsæbɒːniː/
عصبانیت	/æsæbɒːnjjiːæt/
عصبانیت زدن	/æsæbɒːniːjjætzædæn/
عصر	/æsɾ/
عصرانه	/æsɾɒːne/
عصر بخیر	/æsɾ bexejɾ/
عصر هسته‌ای	/æsɾe hæsteʔiː/
عضله	/ʔæzole/
عطر	/ætɾ/
عطر زدن	/ætɾzædæn/
عطسه	/ætse/
عطسه زدن	/ætsezædæn/
عطسه کردن	/ætsekæɾdæn/
عطسه گرفتن	/ætseɡeɾeftæn/
عظیم	/æziːm/
عفو	/æf/
عفو خوردن	/æfxoɾdæn/
عفو کردن	/æfkæɾdæn/
عق	/oɢ/
عق	/oɢɢ/
عقاب	/ʔoɢɒːb/
عقاب	/oɢɒːb/
عقاب طلایی	/oɢɒːbe tælɒːjiː/
عقب	/æɢæb/
عقب	/ʔæɢb/
عقب افتادن	/æɢæboftɒːdæn/
عقب زدن	/æɢæbzædæn/
عقب نشینی	/æɢæb niːʃiːniː/
عقد	/æɢd/
عقد درآمدن	/æɢddæɾɒːmædæn/
عقد شدن	/æɢdʃodæn/
عقد کردن	/æɢdkæɾdæn/
عقیده	/æɢiːde/
عقرب	/ʔæɢɾæb/
عقرب	/æɢɾæb/
عقرب زدن	/æɢɾæbzædæn/
عق زدن	/oɢzædæn/
عقیق سلیمانی	/æɢiːɢe solejmɒːniː/
عق گرفتن	/oɢɢɡeɾeftæn/
عقل	/æɢæl/
عکاس	/ʔækkɒːs/
عکاسی	/ækkɒːsiː/
عکس	/æks/
عکس گرفتن	/æksɡeɾeftæn/
علاقه	/ælɒːɢe/
علاقه داشتن	/ælɒːɢedɒːʃtæn/
عیلام	/iːlɒːm/
علامت	/ælɒːmæt/
علامت تعجیب	/ʔælɒːmæte tæʔd͡ʒiːb/
علامت جمع	/ʔælɒːmæte d͡ʒæmʔ/
علامت خوردن	/ælɒːmætxoɾdæn/
علامت زدن	/ælɒːmætzædæn/
علامت مساوی	/ʔælɒːmæte mosɒːviː/
علامت منها	/ʔælɒːmæte menhɒː/
علی بابا	/ʔæliː bɒːbɒː/
علف	/ælæf/
علم	/ʔælæm/
علم	/ʔelm/
علمی	/elmiː/
علم اخلاق	/ʔelme æxlɒːɢ/
علم معانی	/ʔelm mæʔɒːniː/
عمان	/ommɒːn/
عمدی	/ʔæmdiː/
عمرة	/ʻæmɾæt/
عمیق	/ʔæmiːɢ/
عمل	/æmæl/
عمل آمدن	/æmælɒːmædæn/
عمه	/ʔæmme/
عمه	/æmme/
عمه‌زاده	/æmmezɒːde/
عمو	/ʔæmuː/
عمو	/æmuː/
عموزاده	/æmuːzɒːde/
یعنی	/jæʔniː/
عنان	/ænɒːn/
عنان زدن	/ænɒːnzædæn/
عنبر	/ʔænbæɾ/
عنبیه	/ʔenæbiːje/
عینک	/eiːnæk/
عینک	/ejnæk/
عینک آفتابی	/eiːnæk ɒːftɒːbiː/
عنکبوت	/ʔænkæbuːt/
عنکبوت	/ænkæbuːt/
عینک زدن	/ejnækzædæn/
عنوان	/ʔenovɒːn/
عنوان	/onvɒːn/
عنوان کردن	/onvɒːnkæɾdæn/
عهده	/ohde/
عهده داشتن	/ohdedɒːʃtæn/
عوض	/ævæz/
عوض شدن	/ævæzʃodæn/
عوض کردن	/ævæzkæɾdæn/
عيد فطر	/ejde fetɾ/
غایی	/ɢɒːjiː/
غار	/ɢɒːɾ/
غارت	/ɢɒːɾæt/
غارت کردن	/ɢɒːɾætkæɾdæn/
غاز	/ɢɒːz/
غیب	/ɢejb/
غیبت	/ɢejbæt/
غیبت کردن	/ɢejbætkæɾdæn/
غیب زدن	/ɢejbzædæn/
غده	/ɢodde/
غذا	/ɢæzɒː/
غر	/ɢoɾ/
غراب	/ɢoɾɒːb/
غیرالکلی	/ɢejɾeælkoliː/
غرب	/ɢæɾb/
غربی	/ɢæɾbiː/
غریبه	/ɢæɾiːbe/
غر زدن	/ɢoɾzædæn/
غریزه	/ɢæɾiːze/
غرش	/ɢoɾɾeʃ/
غر غر	/ɢoɾ ɢoɾ/
غر غر کردن	/ɢoɾɢoɾkæɾdæn/
غیر مجاز کردن	/ɢejɾe mod͡ʒɒːz kæɾdæn/
غروب	/ɢoɾuːb/
غروب کردن	/ɢoɾuːbkæɾdæn/
غرور	/ɢoɾuːɾ/
غزال	/ɢæzɒːl/
غزال افریقا	/ɢæzɒːle ɒːfɾiːɢɒː/
غزال آفریقائی	/ɢæzɒːle ɒːfɾiːɢɒːʔiː/
غزه	/ɢæze/
غسل	/ɢosl/
غسل کردن	/ɢoslkæɾdæn/
غش	/ɢæʃ/
غش غش	/ɢæʃ ɢæʃ/
غش غش زدن	/ɢæʃɢæʃzædæn/
غش غش کردن	/ɢæʃɢæʃkæɾdæn/
غش کردن	/ɢæʃkæɾdæn/
غش و ضعف	/ɢæʃ o zæʔf/
غش و ضعف زدن	/ɢæʃozæʔfzædæn/
غصه	/ɢosse/
غصه خوردن	/ɢossexoɾdæn/
غلیان	/ɢæljɒːn/
غلبه	/ɢælæbe/
غلبه کردن	/ɢælæbekæɾdæn/
غلت	/ɢælt/
غلت خوردن	/ɢæltxoɾdæn/
غلت زدن	/ɢæltzædæn/
غلط	/ɢælæt/
غم	/ɢæm/
غم خوردن	/ɢæmxoɾdæn/
غمگین	/ɢæmɡiːn/
غنی	/ɢæniː/
غنچه	/ɢont͡ʃæ/, /ɢont͡ʃe/
غنچه	/ɢont͡ʃe/
غنچه دادن	/ɢont͡ʃæ dɒːdæn/, /ɢont͡ʃe dɒːdæn/
غنچه دادن	/ɢont͡ʃedɒːdæn/
غنودن	/ɢonuːdæn/
غنوصی	/ɢnuːsiː/
غوطه	/ɢuːte/
غوطه زدن	/ɢuːtezædæn/
غوغا	/ɢouːɢɒː/, /ɢævɢɒː/
غول	/ɢuːl/
غيرانتفاعي	/ɢeiːɾeentefæʔiː/
فی	/fiː/
فاحشه	/fɒːheʃe/
فاحشه‌خانه	/fɒːheʃexɒːne/
فاخته	/fɒːxtæ/
فایده	/fɒːjede/
فارس	/fɒːɾs/
فارسی	/fɒːɾsiː/
فارسی تاجیکی	/fɒːɾsiːje tɒːd͡ʒiːkiː/
فارسی دری	/fɒːɾsiːje dæɾiː/
فارماکولوژی	/fɒːɾmɒːkoloʒiː/
فاز	/fɒːz/
فاس	/fɒːs/
فاشیسم	/fɒːʃiːsæm/
فاصله	/fɒːsele/
فاصله مجازی	/fɒːseleje mæd͡ʒɒːziː/
فاصله نشکن	/fɒːseleje næʃkæn/
فاکس	/fɒːks/
فاکس زدن	/fækszædæn/
فاکس کردن	/fækskæɾdæn/
فامیل	/fɒːmiːl/
فانوس	/fɒːnuːs/
فانوس دریایی	/fɒːnuːse dæɾjɒːjiː/
فیت	/fiːt/
فتادن	/fetɒːdæn/
فتحه	/fæthe/
فیجی	/fiːd͡ʒiː/
فحش	/fohʃ/
فحش دادن	/fohʃdɒːdæn/
فدراسیون	/fedeɾɒːsjuːn/
فدراسیون روسیه	/fedeɾɒːsjuːne ɾuːsiːje/
فر	/feɾ/
فرا	/fæɾɒː/
فرات	/foɾɒːt/
فراخواندن	/fæɾɒːxvɒːndæn/
فریاد	/fæɾjɒːd/
فراداده	/fæɾɒːdɒːde/
فریاد آمدن	/fæɾjɒːdɒːmædæn/
فریاد زدن	/fæɾjɒːd zædæn/
فریاد زدن	/fæɾjɒːdzædæn/
فریاد کردن	/fæɾjɒːd kæɾdæn/
فریاد کشیدن	/fæɾjɒːdkeʃiːdæn/
فرار	/fæɾɒːɾ/
فراری	/feɾɒːɾiː/
فرار کردن	/fæɾɒːɾkæɾdæn/
فراز	/fæɾɒːz/
فراكهكشانی	/fæɾɒːkæhkeʃɒːniː/
فراگیر	/fæɾɒːɡiːɾ/
فراموشی	/fæɾɒːmuːʃiː/
فراموشی زدن	/fæɾɒːmuːʃiːzædæn/
فراموشکاری	/fæɾɒːmuːʃkɒːɾiː/
فراموشکاری زدن	/fæɾɒːmuːʃkɒːɾiːzædæn/
فراموش کردن	/fæɾɒːmuːʃ kæɾdæn/
فرآیند	/fæɾɒːjænd/
فرانسیم	/feɾɒːnsiːjom/
فرانسه	/fɾɒːnse/
فرانسوی	/fæɾɒːnsæviː/
فرانسویان	/fæɾɒːnsæviːjɒːn/
فریبا	/fæɾiːbɒː/
فریبکار	/fæɾiːbkɒːɾ/
فربود	/fæɾbuːd/
فرج	/fæɾd͡ʒ/
فرجام	/fæɾd͡ʒɒːm/
فر خوردن	/feɾxoɾdæn/
فردا	/fæɾdɒː/
فردا بعد از ظهر	/fæɾdɒː bæʔd æz zohɾ/
فردا شب	/fæɾdɒː ʃæb/
فردا صبح	/fæɾdɒː sobh/
فردا غروب	/fæɾdɒː ɢoɾuːb/
فردریش	/feɾedɾiːʃ/
فردریک	/feɾedɾiːk/
فردوس	/feɾdoʊs/
فریزی	/feɾiːziː/
فرز	/feɾz/
فرزان	/fæɾzɒːn/
فر زدن	/feɾzædæn/
فرزین	/fæɾziːn/
فرزند	/fæɾzænd/
فرستادن	/feɾestɒːdæn/
فرسودن	/fæɾsuːdæn/
فرش	/fæɾʃ/
فرشته	/feɾeʃte/
فرش کردن	/fæɾʃ kæɾdæn/
فرش کردن	/fæɾʃkæɾdæn/
فرصت	/foɾsæt/
فرضی	/fæɾziː/
فرض کردن	/fæɾz kæɾdæn/
فرضیه	/fæɾziːje/
فرعون	/fæɾʔæwn/
فرق	/fæɾɢ/
فرمان	/fæɾmɒːn/
فرماندار	/fæɾmɒːndɒːɾ/
فرمانده کل قوا	/fæɾmɒːndeje kolle ɢovɒː/
فرمانروایی	/fæɾmɒːnɾævɒːjiː/
فرمودن	/fæɾmuːdæn/
فرمول	/foɾmuːl/
فرمیون	/feɾmiːjon/
فرنشین	/fæɾneʃiːn/
فرهنگ	/fæɾhænɡ/
فرهنگستان	/fæɾhænɡestɒːn/
فرهنگ‌نویسی	/fæɾhænɡnæviːsiː/
فروختن	/foɾuːxtæn/
فرودگاه	/foɾuːdɡɒːh/
فروردین	/fæɾvæɾdiːn/
فروزان	/fɾuːzɒːn/
فیروزه	/fiːɾuːze/
فیروزه‌ای	/fiːɾuːzejiː/
فروسرخ	/foɾuːsoɾx/
فروغ	/fɾuːĝ/
فرومون	/feɾuːmuːn/
فیزیک	/fiːziːk/
فیزیک اتمی	/fiːziːke ætomiː/
فیزیک هسته‌ای	/fiːziːke hæsteʔiː/
فساد	/fesɒːd/, /fæsɒːd/
فیس بوک	/fesbuːk/
فسرده	/fesoɾde/
فسفر	/fosfoɾ/
فشار	/feʃæɾ/
فشار دادن	/feʃæɾdɒːdæn/
فشار دادن	/feʃɒːɾ dɒːdæn/
فصح	/feʃ/
فصل	/fæsl/
فیصل‌آباد	/fejsælɒːbɒːd/
فضا	/fæzɒː/
فضایی	/fæzɒːjiː/
فضای بیرونی	/fæzɒːje biːɾuːniː/
فضاپیما	/fæzɒːpeiːmɒː/
فضازمان	/fæzɒːzæmɒːn/
فضانورد	/fæzɒːnævæɾd/
فعالیت	/fæʔɒːliːjæt/
فعل	/feʔl/
فغان	/fæɢɒːn/
فقر	/fæɢɾ/
فقیر	/fæɢiːɾ/
فقط	/fæɢæt/
فک	/fæk/
فکر	/fekɾ/
فکر افتادن	/fekɾoftɒːdæn/
فکر رفتن	/fekɾɾæftæn/
فکر کردن	/fekɾ kæɾdæn/
فکر کردن	/fekɾkæɾdæn/
فیکساتور	/fiːksɒːtoɾ/
فیکساتور زدن	/fiːksɒːtoɾzædæn/
فکس کردن	/fæks kæɾdæn/
فیل	/fiːl/
فلاطون	/flɒːtuːn/
فلافل	/fælɒːfel/
فیلیپین	/fiːliːpiːn/
فلز	/felez/
فلسطین	/felestiːn/
فلسفه اخلاق	/fælsæfeje æxlɒːɢ/
فلفل	/felfel/
فلفل دلمه‌ای	/felfele dolmeiː/
فلفل قرمز	/felfele ɢeɾmez/
فلفل قرمز	/felfel ɢeɾmez/
فیلم	/fiːlm/
فیلم ترسناک	/fiːlme tæɾsnɒːk/
فلوت	/fluːt/
فلوریدا	/feloɾiːdɒː/
فلوئور	/foluːʔoɾ/, /feloʔoɾ/, /fluːʔoɾ/
فمینیسم	/femiːniːsm/
فن	/fæn/
فینال	/fiːnɒːl/
فن الکتریکی	/fæn elektɾiːkiː/
فناوری	/fænnɒːvæɾiː/
فنجان	/fend͡ʒɒːn/
فندق	/fændoɢ/
فندک	/fændæk/
فنلاند	/fænlɒːnd/
فنلاندی	/fænlɒːndiː/
فهرست	/fehɾest/
فهرست پی‌گیری‌ها	/fehɾeste pejɡiːɾiːhɒː/
فهرست کردن	/fehɾest kæɾdæn/
فهرست محتویات	/fehɾeste mohtæviːjɒːt/
فهمیدید	/fæhmiːdiːd/
فهمیدم	/fæhmiːdæm/
فهمیدن	/fæhmiːdæn/
فواره	/fævvɒːɾe/
فواره زدن	/fævvɒːɾezædæn/
فوت	/foʊt/
فوت	/fuːt/
فوتبال	/fuːtbɒːl/
فوتبالیست	/fuːtbɒːliːst/
فوت کردن	/foʊtkæɾdæn/
فوت کردن	/fuːtkæɾdæn/
فوتوکپی	/fotokopiː/
فوتون	/foton/
فورا	/fævɾæn/
فوران	/fævæɾɒːn/
فوران زدن	/fævæɾɒːnzædæn/
فوران کردن	/fævæɾɒːnkæɾdæn/
فوریه	/fevɾiːje/
فولاد	/fuːlɒːd/
فيليپ	/fiːliːp/
قاب	/ɢɒːb/
قاب کردن	/ɢɒːbkæɾdæn/
قابل نداشت	/ɢɒːbel nædɒːʃt/
قاپ	/ɢɒːp/
قاپ زدن	/ɢɒːpzædæn/
قاتل	/ɢɒːtel/
قاچ	/ɢɒːt͡ʃ/
قاچ خوردن	/ɢɒːt͡ʃxoɾdæn/
قاچ زدن	/ɢɒːt͡ʃzædæn/
قاچ کردن	/ɢɒːt͡ʃkæɾdæn/
قار	/ɢɒːɾ/
قارچ	/ɢɒːɾt͡ʃ/
قار زدن	/ɢɒːɾzædæn/
قاره	/ɢɒːɾe/
قاشق	/ɢɒːʃoɢ/, /ɢɒːʃeɢ/
قاصدک	/ɢɒːsedæk/
قاضی	/ɢɒːziː/
قیافه	/ɢiːɒːfe/
قایق	/ɢɒːjeɢ/
قایق اژدها	/ɢɒːjeɢ eʒdehæ/
قالی	/ɢɒːliː/
قالیچه	/ɢɒːliːt͡ʃe/
قالیچه پرنده	/ɢɒːliːt͡ʃeje pæɾænde/
قانقاریا	/ɢɒːnɢɒːɾjɒː/
قانون	/ɢɒːnuːn/
قانون زدن	/ɢɒːnuːnzædæn/
قاهره	/ɢɒːheɾe/
قبا	/ɢæbɒː/
قبر	/ɢæbɾ/
قبرستان	/ɢæbɾestɒːn/
قبل	/ɢæbl/
قبلا	/ɢæblæn/
قبله	/ɢeble/
قبول	/ɢæbuːl/
قبول کردن	/ɢæbuːl kæɾdæn/
قبول کردن	/ɢæbuːlkæɾdæn/
قتل	/ɢætl/
قیچی	/ɢejt͡ʃiː/
قیچی زدن	/ɢejt͡ʃiːzædæn/
قیچی کردن	/ɢejt͡ʃiːkæɾdæn/
قحبه‌خانه	/ɢæhbexɒːne/
قد	/ɢæd/
قید	/ɢejd/
قدرت	/ɢodɾæt/
قید زدن	/ɢejdzædæn/
قدس	/ɢods/
قدس شریف	/ɢodse ʃæɾiːf/
قد کشیدن	/ɢædkeʃiːdæn/
قدم	/ɢædæm/
قدیمی	/ɢædiːmiː/
قدم زدن	/ɢædæm zædæn/
قدم زدن	/ɢædæmzædæn/
قرار	/ɢæɾɒːɾ/
قرارداد	/ɢæɾɒːɾdɒːd/
قرارداد زدن	/ɢæɾɒːɾdɒːdzædæn/
قرار زدن	/ɢæɾɒːɾzædæn/
قرارملاقات	/ɢæɾɒːɾe molɒːɢɒːt/
قرارملاقات گرفتن	/e molɒːɢɒːtɡeɾeftæn/
قرآن	/ɢoɾʔɒːn/
قربانی	/ɢoɾbɒːniː/
قربانی کردن	/ɢoɾbɒːniːkæɾdæn/
قرص	/ɢoɾse/
قرض	/ɢæɾz/
قرقاول	/ɢæɾɢɒːvol/
قرقیزی	/ɢiːɾɢiːziː/
قرقیزستان	/ɢeɾɢiːzestɒːn/
قرمز	/ɢeɾmez/
قرمزی	/ɢeɾmeziː/
قرن	/ɢæɾn/
قرنیه	/ɢæɾniːje/
قره‌باغ	/ɢæɾebɒːɢ/
قره‌باغ کوهستانی	/ɢæɾebɒːɢe kuːhestɒːniː/
قزاقی	/ɢæzɒːɢiː/
قزاق	/ɢæzzɒːɢ/
قزاقستان	/ɢæzzɒːɢestɒːn/
قسم	/ɢæsæm/
قسمت	/ɢesmæt/
قسم خوردن	/ɢæsæmxoɾdæn/
قشلاق	/ɢeʃlɒːɢ/
قشنگ	/ɢæʃænɡ/
قصاب	/ɢæssɒːb/
قصد	/ɢæsd/
قصد داشتن	/ɢæsddɒːʃtæn/
قصد کردن	/ɢæsdkæɾdæn/
قیصر	/ɢejsæɾ/
قطار	/ɢetɒːɾ/
قطب جنوب	/ɢotbe d͡ʒonuːb/
قطب شمال	/ɢotbe ʃomɒːl/
قطب‌نما	/ɢotbnæmɒː/
قطر	/ɢætæɾ/
قطره	/ɢætɾe/
‌قطع	/ɢætʔ/
‌قطع شدن	/ɢætʔʃodæn/
‌قطع کردن	/ɢætʔkæɾdæn/
قیف	/ɢiːf/
قفس	/ɢæfæs/
قفسه کتاب	/ɢæfæseje ketɒːb/
قفقاز	/ɢæfɢɒːz/
قفقازی	/ɢæfɢɒːziː/
قفقاز جنوبی	/ɢæfɢɒːze d͡ʒonuːbiː/
قفقاز شمالی	/ɢæfɢɒːze ʃæmɒːliː/
قفل	/ɢofl/
قفل زدن	/ɢoflzædæn/
قفل کردن	/ɢofl kæɾdæn/
قفل کردن	/ɢoflkæɾdæn/
ققنس	/ɢæɢnos/
قل	/ɢol/
قلیا	/ɢæliːɒː/
قلاب	/ɢollɒːb/
قلاب ماهيگيري	/ɢollɒːb mɒːhiːɡiːɾiː/
قلیان	/ɢæljɒːn/
قلب	/ɢælb/
قلبی	/ɢælbiː/
قل خوردن	/ɢolxoɾdæn/
قل زدن	/ɢolzædæn/
قلعه	/ɢælʔe/
قل قل	/ɢolɢol/
قل قل زدن	/ɢolɢolzædæn/
قلقلک	/ɢelɢelæk/
قلقلک دادن	/ɢelɢelækdɒːdæn/
قلم	/ɢælæm/
قلم زدن	/ɢælæmzædæn/
قلمه	/ɢælæme/
قلمه خوردن	/ɢælæmexoɾdæn/
قلمه زدن	/ɢælæmezædæn/
قلمه کردن	/ɢælæmekæɾdæn/
قله	/ɢolle/
قلیون	/ɢæljuːn/
قم	/ɢom/
قمار	/ɢomɒːɾ/
قمار زدن	/ɢomɒːɾzædæn/
قیماغ	/ɢejmɒːɢ/
قیماق	/ɢejmɒːɢ/
قیمت	/ɢejmæt/
قیمق	/ɢejmæɢ/
یقین	/jɒːɢiːn/
قناری	/ɢænɒːɾiː/
قناس	/ɢenɒːs/
قند	/ɢænd/
قندوز	/ɢonduːz/
یقین کردن	/jæɢiːnkæɾdæn/
یقه	/jæɢe/
قهر	/ɢæhɾ/
قهر کردن	/ɢæhɾkæɾdæn/
قهرمان	/ɢæhɾemɒːn/
قهقهه	/ɢæhɢæhe/
قهقهه زدن	/ɢæhɢæhezædæn/
قهوه	/ɢæhve/
قهوه‌ای	/ɢæhveʔiː/
قهوه‌ای	/ɢæhveiː/
قهوه‌ای	/ɢæhvejiː/
قهوهای شدن	/ɢæhveʔiː ʃodæn/
قهوه‌خانه	/ɢæhvexɒːne/
قهوه سیاه	/ɢæhve siːjɒːh/
قوی	/ɢæviː/
قو	/ɢuː/
قواخ	/ɢævɒːx/
قوچ	/ɢuːt͡ʃ/
قورباغه	/ɢuːɾbɒːɢe/
قورت	/ɢuːɾt/
قورت دادن	/ɢuːɾtdɒːdæn/
قوزک	/ɢuːzæk/
قوزک پا	/ɢuːzæke pɒː/
قوس	/ɢoʊs/
قوی سیاه	/ɢuːje siːjɒːh/
قوس زدن	/ɢoʊszædæn/
قوس و قزح	/ɢoʊs o ɢæzæh/
قوطى	/ɢuːtiː/
قول	/ɢoʊl/
قول	/ɢol/
قول	/ɢol/, /ɢoʊl/
قول زدن	/ɢolzædæn/, /ɢoʊlzædæn/
قول گرفتن	/ɢoʊlɡeɾeftæn/
قوم	/ɢoʊm/
قومیت	/ɢoʊmiːjjæt/
قياس	/ɢiːɒːs/
قياس کردن	/ɢiːɒːskæɾdæn/
كالبد	/kɒːlbod/
كانا	/kɒːnɒː/
كبریت	/kebɾiːt/
كبریت زدن	/kebɾiːtzædæn/
كبریت کشیدن	/kebɾiːtkeʃiːdæn/
كپور	/kæpuːɾ/
كروآت	/kɾoɒːt/
كیف	/kejf/
كیف دادن	/kejfdɒːdæn/
كیف کردن	/kejfkæɾdæn/
كم‌گوش	/kæmɡuːʃ/
كه	/ke/
كو كلوكس كلان	/kuː kluːks klɒːn/
کی ۲	/kej doh/
یک	/jek/
یکی	/jekiː/
کی	/kej/, /kiː/
کاباره	/kɒːbɒːɾe/
کابل	/kɒːbol/
کابوس	/kɒːbuːs/
کاپوت	/kɒːpuːt/
کاپوچینو	/kɒːpuːt͡ʃiːnuː/
کاتالانی	/kætælɒːniː/
کاتولیک	/kɒːtoliːk/
کاج	/kɒːd͡ʒ/
کاخ	/kɒːx/
کاخ سفید	/kɒːxe sæfiːd/
کاخ کرملین	/kɒːxe kɾemliːn/
کادمیوم	/kɒːdmiːjom/
کار	/kɒːɾ/
کاری است که شده	/kɒːɾiː æst ke ʃode/
کار افتادن	/kɒːɾoftɒːdæn/
کارآگاه	/kɒːɾɒːɡɒːh/
کاراگاه	/kɒːɾɒːɡɒːh/
کارآموز	/kɒːɾɒːmuːz/
کار انداختن	/kɒːɾændɒːxtæn/
کاربر	/kɒːɾbæɾ/
کار بردن	/kɒːɾboɾdæn/
کار بستن	/kɒːɾbæstæn/
کارتاژ	/kæɾtɒːʒ/
کارت اعتباری	/kɒːɾte eʔtebɒːɾ/
کارت پستال	/kɒːɾt postɒːl/
کارتن	/kɒːɾton/
کارخانه	/kɒːɾxɒːne/
کارد	/kɒːɾd/
کارد خوردن	/kɒːɾdxoɾdæn/
کارد زدن	/kɒːɾdzædæn/
کارفرما	/kɒːɾfæɾmɒː/
کار کردن	/kɒːɾ kæɾdæn/
کار کردن	/kɒːɾkæɾdæn/
کارگر	/kɒːɾɡæɾ/
کار گرفتن	/kɒːɾɡeɾeftæn/
کار گروهی	/kɒːɾe ɡoɾuːhiː/
کارل	/kɒːɾl/
کارمزد	/kɒːɾmozd/
کارمند	/kɒːɾmænd/
کارناوال	/kɒːɾnɒːvɒːl/
کارنوال	/kɒːɾnevɒːl/
کاروان	/kɒːɾvɒːn/
کاروان‌سرا	/kɒːɾvɒːnsæɾɒː/
کازاخستان	/kɒːzɒːxestɒːn/
کاست	/kɒːst/
کاسنی	/kɒːsniː/
کاسه	/kɒːse/
کاشتن	/kɒːʃtæn/
کاشته	/kɒːʃte/
کاشته زدن	/kɒːʃtezædæn/
کاشغر	/kɒːʃɢæɾ/
کاشف	/kɒːʃef/
کاغذ	/kɒːɢæz/
کاغذی	/kɒːɢæziː/
کاغذدیواری	/kɒːɢæzdiːvɒːɾiː/
کاغذدیواری کردن	/kɒːɢæzdiːvɒːɾiː kæɾdæn/
کاغذ روزنامه	/kɒːɢæze ɾuːznɒːme/
کاف	/kɒːf/
کافی	/kɒːfiː/
کافر	/kɒːfæɾ/
کافر	/kɒːfeɾ/
کافه	/kɒːfe/
کاکائو	/kɒːkɒːoje/
کالبدشناسی	/kɒːlbodʃenɒːsiː/
کالیفرنیا	/kɒːliːfoɾniːɒː/
کالیفرنیم	/kɒːliːfoɾniːom/
کام	/kɒːm/
کاما سوترا	/kɒːmɒː suːtɾɒː/
کامامبر	/kɒːmɒːmbeɾ/
کامبوج	/kɒːmbuːd͡ʒ/
کامپیوتر	/kɒːmpjuːteɾ/
کام کشیدن	/kɒːmkeʃiːdæn/
کام گرفتن	/kɒːmɡeɾeftæn/
کامل	/kɒːmel/
کامیون	/kɒːmiːon/
کان	/kɒːn/
کانی	/kɒːniː/
کانادا	/kɒːnɒːdɒː/
کانال	/kɒːnɒːl/
کانال مانش	/kɒːnɒːl mɒːnʃ/
کانبرا	/kɒːnbæɾɒː/
کانجی	/kɒːnd͡ʒiː/
کانی‌شناسی	/kɒːniːʃenɒːsiː/
کانگورو	/kɒːnɡoɾo/
کاهش	/kɒːheʃ/
کاهش دادن	/kɒːheʃdɒːdæn/
کاهش گرفتن	/kɒːheʃɡeɾeftæn/
کاهو	/kɒːhuː/
کباب	/kebɒːb/
کباب کردن	/kæbɒːb kæɾdæn/
یک‌بار	/jekbɒːɾ/
کبالت	/kobɒːlt/
کبد	/kæbed/
کبریت	/kebɾiːt/
کبک	/kebek/
کبوتر	/kæbuːtæɾ/
کبوتر چاهی	/kæbuːtæɾ t͡ʃɒːhiː/
یکی بود یکی نبود	/jekiː buːd jekiː næbuːd/
کیبورد	/kiːboɾd/
کپی	/kæpiː/
کپی	/kopiː/
کیپا	/kiːpɒː/
کپک	/kæpæk/
کپی کردن	/kæpiː kæɾdæn/
کپی کردن	/kopj kæɾdæn/
کپک زدن	/kæpækzædæn/
کپنهاگ	/kopenhɒːɡ/
یکتا	/jektɒː/
کتاب	/ketɒːb/
کتاب الکترونیکی	/ketɒːb e elektɾoniːkiː/
کتابخانه	/ketɒːbxɒːne/
کتابدار	/ketɒːbdɒːɾ/
کتاب داوران	/ketɒːb dæwɾæn/
کتاب عبارت	/ketɒːbe ʔebɒːɾæt/
کتاب‌فروشی	/ketɒːbfoɾoʃiː/
کتاب‌فروش	/ketɒːbfoɾuːʃ/
کتاب مقدس	/ketɒːbe moɢæddæs/
یکتاپرستی	/jektɒːpæɾæstiː/
کتبی	/kætbiː/
کتری	/ketɾiː/
کتف	/ketf/
کتک	/kotæk/
کتک خوردن	/kotækxoɾdæn/
کتک زدن	/kotækzædæn/
کثافت	/kesɒːfæt/
کثافت زدن	/kesɒːfætzædæn/
کثافت کشیدن	/kesɒːfætkeʃiːdæn/
کجا	/kod͡ʒɒː/
کدام	/kodɒːm/
کد پستی	/kode postiː/
کده	/kæde/
کدو تنبل	/kæduː tænbæl/
کر	/kæɾ/
کیر	/kiːɾ/
کراتین	/keɾɒːtiːn/
کراچی	/kæɾɒːt͡ʃiː/
کرایست‌چرچ	/kɾɒːjstt͡ʃeɾt͡ʃ/
کرایه	/keɾɒːjæ/
کرایه دادن	/keɾɒːjæ dɒːdæn/
کرایه کردن	/keɾɒːjæ kæɾdæn/
کراوات	/keɾɒːvɒːt/
کراوات زدن	/keɾɒːvɒːtzædæn/
کربن	/kæɾbon/
کرت	/keɾet/
کرد	/koɾd/
کردی	/koɾdiː/
کردار	/keɾdɒːɾ/
کردستان	/koɾdestɒːn/
کردن	/kæɾdæn/
کردنی	/kæɾdæniː/
کرسی	/koɾsiː/
کرسی زدن	/koɾsiːzædæn/
کریسمس	/keɾiːsmæs/
کرفس	/kæɾæfs/
کریکت	/kɾiːket/
کرکس	/kæɾkæs/
کرگوشی	/kæɾɡuːʃiː/
کرگوشی زدن	/kæɾɡuːʃiːzædæn/
کرم	/kæɾæm/
کرم	/keɾem/
کرم	/keɾm/
کرم زدن	/keɾemzædæn/
کیر مکیدن	/kiːɾ mekiːdæn/
کرملین	/kɾemliːn/
کرنر	/koɾneɾ/
کرنر زدن	/koɾneɾzædæn/
کره	/kæɾe/
کره	/koɾɾe/
کره	/koɾe/
کره جنوبی	/koɾeje d͡ʒænuːbiː/
کره زدن	/kæɾezædæn/
کره شمالی	/koɾeje ʃemɒːliː/
کرواسی	/koɾoɒːsiː/
کروکودیل	/kɾokodiːl/
کروم	/koɾom/
کس	/kæs/
کسی	/kæsiː/
کس	/kos/
کسی	/ksiː/
یکسان	/jeksɒːn/
کسره	/kæsɾe/
کسشعر	/koseʃeʔɾ/, /kosʃeʔɾ/
کس‌کش	/koskeʃ/
کس‌کشی	/koskeʃiː/
کس لیسیدن	/kos liːsiːdæn/
کسل کننده	/keselkonænde/
کیسه	/kiːse/
کیسه بیضه	/kiːseje bejze/
کیسه خایه	/kiːseje xɒːje/
کیسه زدن	/kiːsezædæn/
کیسه کشیدن	/kiːsekeʃiːdæn/
کیش	/kiːʃ/
کشاورز	/keʃɒːvæɾz/
کشاورزی	/keʃɒːvæɾziː/
کشتی	/kæʃtiː/
کشت	/keʃt/
کشتی	/koʃtiː/
کشتارگاه	/koʃtɒːɾɡɒːh/
کشتی فضایی	/kæʃtiːefæzɒːje/
کشتی گذاره	/kæʃtiːjeɡozɒːɾæh/
کشتی گرفتن	/koʃtiːɡeɾeftæn/
کشتن	/koʃtæn/
کشتی نوح	/kæʃtiːje nuːh/
کشتی هوایی	/kæʃtiːje hævɒːjiː/
کشیدن	/keʃiːdæn/
کشیده	/kæʃiːdæ/, /kæʃiːde/
کشیده	/keʃiːde/
کشیده خوردن	/keʃiːdexoɾdæn/
کشیده زدن	/keʃiːdezædæn/
کشیش	/keʃiːʃ/
کشف	/kæʃf/
کشف شدن	/kæʃfʃodæn/
کشف کردن	/kæʃf kæɾdæn/
کشف کردن	/kæʃfkæɾdæn/
کشکک زانو	/kæʃkæk zɒːnuː/
کشمش	/keʃmeʃ/
یکشنبه	/jekʃænbe/
یک‌شنبه	/jekʃænbe/
کشنده	/keʃænde/
کیشینف	/kiːʃiːnef/
کشو	/keʃo/
کشور	/keʃvæɾ/
کیش و مات	/kiːʃomɒːt/
کعبه	/kæʔbe/
کف	/kæf/
کیف	/kejf/
کیف	/kiːf/
کیف	/kiːjef/
کفاره	/kæffɒːɾe/
کفاره دادن	/kæffɒːɾedɒːdæn/
کفاش	/kæffɒːʃ/
کف پا	/kæfe pɒː/
کیف پول	/kiːfe puːl/
کیفیت	/kejfiːjæt/
کفتار	/kæftɒːɾ/
کفتر	/kæftæɾ/
کف دادن	/kæfdɒːdæn/
کف دست	/kæfe dæst/
کفیر	/kefiːɾ/
کف زدن	/kæfzædæn/
کیف زدن	/kiːfzædæn/
کف زمین	/kæfe zæmiːn/
کفش	/kæfʃ/
کفش‌دوزک	/kæfʃduːzæk/
کفش راحتی	/kæfʃe ɾɒːhætiː/
کف گیری	/kæf ɡiːɾiː/
یکی یکی	/jekiː jekiː/
کیک	/kejk/
کک	/kek/
یک کم	/jek kæm/
یک کمی	/jek kæmiː/
کل	/kol/
کلاس	/kelɒːs/
کلاسیک	/klɒːsiːk/
کلاسور	/kelɒːsoɾ/
کلاغ	/kælɒːɢ/
کلان	/kælɒːn/
کلاه	/kolɒːh/
کلید	/keliːd/
کلیدی	/keliːdiː/
کلر	/koloɾ/
کلروفیل	/kloɾofiːl/
کلیسا	/keliːsɒː/
کلسیم	/kælsiːom/
کلفت	/kolfæt/
کلک	/kælæk/
کلک خوردن	/kælækxoɾdæn/
کلک زدن	/kælækzædæn/
کلم	/kælæm/
کلمبیا	/kolombiːjɒː/
کلمه	/kælæme/
کلن	/koln/
کلنجار	/kælænd͡ʒɒːɾ/
کلنگ	/kolænɡ/
کلنگ زدن	/kolænɡzædæn/
کله	/kællæ/, /kælle/
کله	/kælle/
کلیه	/kolje/
کلّه خر	/kælle xæɾ/
کله زدن	/kællezædæn/
کلّه سخت	/kælle sæxt/
کله معلق	/kællemoællæɢ/
کله معلق زدن	/kællemoællæɢzædæn/
کیلو	/kiːluː/
کلوچه	/koluːt͡ʃæ/
کیلوگرم	/kiːloɡɾæm/
کیلومتر	/kiːlometɾ/
یکم	/jekom/
کم	/kæm/
کمی	/kæmiː/
کیم	/kiːm/
کم	/kom/
کیمیا	/kiːmiːjɒː/
کمیاب	/kæmjɒːb/
کماره	/kæmɒːɾe/
کیمیاگر	/kiːmiːɒːɡæɾ/
کیمیاگری	/kiːmiːjɒːɡæɾiː/
کمال	/kæmɒːl/
کمان	/kæmɒːn/
کمان‌دار	/kæmɒːndɒːɾ/
کمان زنبورکی	/kæmɒːne zænbuːɾækiː/
کمتر	/kæmtæɾ/
کم حرف	/kæm hæɾf/
کمد	/komod/
کمر	/kæmæɾ/
کمربند	/kæmæɾ bænd/
کمربند	/kæmæɾbænd/
کمردرد	/kæmæɾdæɾd/
کمردرد زدن	/kæmæɾdæɾdzædæn/
کم صدا	/kæm sedɒː/
کمک	/komæk/
کمک کردن	/komæk kæɾdæn/
کمک گرفتن	/komækɡeɾeftæn/
کم گوی	/kæm ɡuːj/
یکمین	/jekomiːn/
کمین	/kæmiːn/
کمند	/kæmænd/
کمین کردن	/kæmiːnkæɾdæn/
کمین گرفتن	/kæmiːnɡeɾeftæn/
کمونیست	/komuːniːst/
کمونیسم	/komuːniːsm/
کنار	/kenɒːɾ/
کنار	/kenɒːɾe/
کنار زدن	/kenɒːɾzædæn/
کناره	/kenɒːɾe/
کناره گیری	/kenɒːɾeɡiːɾiː/
کناره گرفتن	/kenɒːɾeɡeɾeftæn/
کناره گیری کردن	/kenɒːɾeɡiːɾiːkæɾdæn/
کنایه	/kenɒːje/
کنایه زدن	/kenɒːjezædæn/
کنجد	/kond͡ʒed/, /kond͡ʒod/
کندی	/kenediː/
کندن	/kændæn/
کندهار	/kændæhɒːɾ/
کنست	/kneset/
کنستانتینوپول	/konstɒːntiːnopol/
کنسرت	/konseɾt/
کنیسه	/kæniːse/
کنسولگری	/konsuːlɡæɾiː/
کنعان	/kænʔɒːn/
کنف	/kenæf/
کنفرانس	/konfeɾɒːns/
کنگر فرنگی	/kænɡæɾefæɾænɡiː/
کینگستون	/kiːnɡston/
کنه	/kæne/
کینه	/kiːne/
کینه گرفتن	/kiːneɡeɾeftæn/
کنونی	/konuːniː/
که	/kæh/, /ke/, /ke/, /koh/
کیهان	/kejhɒːn/
کهکشان	/kæhkeʃɒːn/
کهن	/kohæn/
کهنه	/kohne/
کوارک	/kuːɒːɾk/
کوآلا	/koɒːlæ/
کوالالامپور	/kvɒːlɒːlɒːmpuːɾ/
کوبا	/kuːbɒː/
کوبیدن	/kuːbiːdæn/
کوپید	/kuːpiːd/
کوپرنیسیم	/kopeɾniːsiːom/
کوپرنیک	/kuːpeɾniːk/
کویت	/koveiːt/
کوتاه	/kuːtɒːh/
کوتاهی	/kuːtɒːhiː/
کوتاهی کردن	/kuːtɒːhiːkæɾdæn/
کوچ	/kuːt͡ʃ/
کوچیدن‌	/kuːt͡ʃiːdæn/
کوچک	/kuːt͡ʃek/
کوچکتر	/kuːt͡ʃæktæɾ/
کوچ کردن	/kuːt͡ʃ kæɾdæn/
کوچه	/kuːt͡ʃe/
کوچ‌ها	/kuːt͡ʃhɒː/
کوچه زدن	/kuːt͡ʃezædæn/
کوچولو	/kuːt͡ʃuːluː/
کودک	/kuːdæk/
کودکستان	/kuːdækestɒːn/
کودن	/kodæn/
کودنی	/koʊdæniː/
کودنی زدن	/koʊdæniːzædæn/
کور	/kuːɾ/
کوری	/kuːɾiː/
کوری زدن	/kuːɾiːzædæn/
کورسو	/kuːɾsuː/
کورسو زدن	/kuːɾsuːzædæn/
کورش	/kuːɾoʃ/
کوریم	/kuːɾiːom/
کوره	/kuːɾæ/
کوزپلی	/kosplej/
کوستروما	/kostɾomɒː/
کیوسک	/kiːjuːsk/
کیوسکموتو	/kjvskmvtv/
کوسه	/kuːse/
کوسوو	/kosovo/
کوشیدن	/kuːŝiːdæn/
کوشش	/kuːŝeŝ/
کوشک	/kuːʃk/
کوفته	/kuːfte/
کوک	/kuːk/
کوکاکولا	/kokɒːkolɒː/
کوکب	/kouːkæb/
کوک خوردن	/kuːkxoɾdæn/
کوک زدن	/kuːkzædæn/
کولی	/koʊliː/
کول	/kuːl/
کول کردن	/kuːlkæɾdæn/
کول گرفتن	/kuːlɡeɾeftæn/
کولون	/kolon/
کومیس	/kuːmiːs/
کون	/kuːn/
کونی	/kuːniː/
کونا	/kuːnɒː/
کونگ فو	/kuːnɡ fuː/
کوه	/kuːh/
کوه زدن	/kuːhzædæn/
کوهستان	/kuːhestɒːn/
گا	/ɡɒː/
گابورون	/ɡɒːboɾon/
گاییدنی	/ɡɒːjedæniː/
گاراژ	/ɡɒːɾɒːʒ/
گاز	/ɡɒːz/
گاز اعصاب	/ɡɒːze æʔsɒːb/
گاز زدن	/ɡɒːzzædæn/
گاز گرفتن	/ɡɒːz ɡeɾeftæn/
گازولین	/ɡɒːzuːliːn/
گام	/ɡɒːm/
گاما	/ɡɒːmɒː/
گامبی	/ɡɒːmbiː/
گام زدن	/ɡɒːm zædæn/
گام زدن	/ɡɒːmzædæn/
گاینده	/ɡɒːjænde/
گاه	/ɡɒːh/
گاهی	/ɡɒːhiː/
گاه به گاه	/ɡɒːh be ɡɒːh/
گیاهخوار	/ɡiːjɒːhxɒːɾ/
گیاه‌شناسی	/ɡiːjɒːhʃenɒːsiː/
گاو	/ɡɒːv/
گاوبندی	/ɡɒːvbændiː/
گاوبندی کردن	/ɡɒːvbændiːkæɾdæn/
گاو نر	/ɡɒːve næɾ/
گائیدن	/ɡɒːʔiːdæn/
گپ	/ɡæp/
گپ زدن	/ɡæpzædæn/
گپيدن	/ɡæpiːdæn/
گیتی	/ɡiːtiː/
گت	/ɡot/, /ɡæt/
گیتار	/ɡiːtɒːɾ/
گیتاریست	/ɡiːtɒːɾiːst/
گیتاشناسی	/ɡiːtɒːʃenɒːsiː/
گتو	/ɡetuː/, /ɡeto/
گجراتی	/ɡod͡ʒæɾɒːtiː/
گچ	/ɡæt͡ʃ/
گدایی	/ɡedɒːjiː/
گدایی زدن	/ɡedɒːjiːzædæn/
گذاشتن	/ɡozɒːʃtæn/
گذاشتن	/to puːt/
گذر	/ɡozæɾ/
گذر کردن	/ɡozæɾkæɾdæn/
گذرنامه	/ɡozæɾnɒːme/
گذشتن	/ɡozæʃtæn/
گذشته	/ɡozæʃte/
گذشته ی بعید	/ɡozæʃteje bæʔiːd/
گیر	/ɡiːɾ/
گر	/ɡoɾ/
گراز	/ɡeɾɒːz/
گراز دریایی	/ɡoɾɒːze dæɾjɒːjiː/
گرایش جنسی	/ɡæɾɒːjeʃe d͡ʒensiː/
گران	/ɡeɾɒːn/
گیر آوردن	/ɡiːɾɒːvæɾdæn/
گریبان	/ɡæɾiːbɒːn/
گربه	/ɡoɾbe/
گربۀ ایرانی	/ɡoɾbeje iːɾɒːniː/
گربۀ پشمالو	/ɡoɾbeje pæʃmɒːluː/
گریپ فروت	/ɡeɾiːpfoɾuːt/
گرجی	/ɡoɾd͡ʒiː/
گرجستان	/ɡoɾd͡ʒestɒːn/
گرچه	/ɡæɾt͡ʃe/
گرد	/ɡæɾd/
گرد	/ɡeɾd/
گردش کار	/ɡæɾdeʃekɒːɾ/
گردن	/ɡæɾdæn/
گردن بند	/ɡæɾdæn bænd/
گردن زدن	/ɡæɾdæn zædæn/
گردن زدن	/ɡæɾdænzædæn/
گردن گرفتن	/ɡæɾdænɡeɾeftæn/
گرده	/ɡoɾde/
گردو	/ɡeɾduː/
گریز	/ɡoɾiːz/
گرز	/ɡoɾz/
گریز زدن	/ɡoɾiːzzædæn/
گریستن	/ɡeɾiːstæn/
گرسنگی	/ɡoɾosneɡiː/
گرسنگی	/ɡɾosnæɡiː/, /ɡɾosneɡiː/
گرسنگی کشیدن	/ɡoɾosneɡiːkeʃiːdæn/
گرسنه	/ɡoɾosne/
گرفت	/ɡeɾeft/
گرفتن	/ɡeɾæftæn/
گرفتن	/ɡeɾeftæn/
گرگ	/ɡoɾɡ/
گر گرفتن	/ɡoɾɡeɾeftæn/
گرگینه	/ɡoɾɡiːne/
گرم	/ɡæɾm/
گرمی	/ɡæɾmiː/
گرم	/ɡeɾæm/
گرما	/ɡæɾmɒː/
گرمساز	/ɡæɾmsɒːz/
گرمک	/ɡæɾmæk/
گرمکن	/ɡæɾmkon/
گرین کارت	/ɡɾiːn kɒːɾt/
گرینلند	/ɡɾiːnlænd/
گره	/ɡeɾe/, /ɡeɾeh/
گریه	/ɡeɾje/
گیره	/ɡiːɾe/
گریه افتادن	/ɡeɾjeoftɒːdæn/
گریه انداختن	/ɡeɾjeændɒːxtæn/
گره خوردن	/ɡeɾehxoɾdæn/
گره زدن	/ɡeɾehzædæn/
گریه زدن	/ɡeɾjezædæn/
گریه کردن	/ɡeɾje kæɾdæn/
گریه کردن	/ɡeɾjekæɾdæn/
گریه گرفتن	/ɡeɾjeɡeɾeftæn/
گروزنی	/ɡɾuːzniː/
گریونا	/ɡɾiːvnɒː/
گروه	/ɡoɾuːh/
گروه	/ɡoɾuːhʔ/
گروه واژه	/ɡoɾuːh vɒːʒe/
گزارش	/ɡozɒːɾeʃ/
گزارشی	/ɡozɒːɾeʃiː/
گزارش دادن	/ɡozɒːɾeʃdɒːdæn/
گزاره	/ɡozɒːɾe/
گزاف گفتن	/ɡæzɒːf ɡoftæn/
گزیدن	/ɡæziːdæn/
گزر	/ɡæzæɾ/
گزنه	/ɡæzne/
گزینه	/ɡoziːne/
گستاخ	/ɡostɒːx/
گستردن	/ɡostæɾdæn/
گسترده	/ɡostæɾde/
گسترده شدن	/ɡostæɾdæ ʃodæn/, /ɡostæɾde ʃodæn/
گسترش	/ɡostæɾeʃ/
گسترش یافتن	/ɡostæɾeʃjɒːftæn/
گسترش دادن	/ɡostæɾeʃdɒːdæn/
گشت	/ɡæʃt/
گشتاپو	/ɡestɒːpuː/
گشت زدن	/ɡæʃtzædæn/
گشتن	/ɡæʃtæn/
گشنیز	/ɡeʃniːz/
گشودن	/ɡoʃuːdæn/
گفتار	/ɡoftɒːɾ/
گفتگو	/ɡofteɡuː/ɡoftoɡuː/
گفتگو	/ɡofteɡuː/, /ɡoftoɡuː/, /ɡoftɡuː/
گفتگو کردن	/ɡofteɡuːkæɾdæn/
گفتن	/ɡoftæn/
گفته	/ɡofte/
گفته شدن	/ɡofte ʃodæn/
گفت و گو	/ɡoft o ɡuː/
گیک	/ɡiːk/
گل	/ɡel/
گل	/ɡol /
گل	/ɡol/
گلاب	/ɡolɒːb/
گلابی	/ɡolɒːbiː/
گیلارد	/ɡiːlɒːɾd/
گیلاس	/ɡiːlɒːs/
گلاسنوست	/ɡlɒːsnost/
گل آفتاب‌گردان	/ɡol æftɒːb ɡæɾdɒːn/
گلایه	/ɡelɒːje/
گلایه کردن	/ɡelɒːjekæɾdæn/
گل آویز	/ɡolɒːviːz/
گلپر	/ɡolpæɾ/
گل خوردن	/ɡolxoɾdæn/
گل دادن	/ɡoldɒːdæn/
گلدان	/ɡoldɒːn/
گلزار	/ɡolzɒːɾ/
گل زدن	/ɡol zædæn/
گل زدن	/ɡolzædæn/
گلف	/ɡolf/
گیلک	/ɡiːlæk/
گل کردن	/ɡol kæɾdæn/
گل کلم	/ɡole kælæm/
گل‌کلم	/ɡolkælæm/
گیلگمش	/ɡiːlɡæmeʃ/
گلو	/ɡæluː/
گلوگاه	/ɡæluːɡɒːh/
گلوله	/ɡoluːle/
گلوله بستن	/ɡoluːlebæstæn/
گلوله خوردن	/ɡoluːlexoɾdæn/
گلوله زدن	/ɡoluːlezædæn/
گماردن	/ɡomɒːɾdæn/
گمان 	/ɡomɒːn/
گمان	/ɡomɒːn/
گمان بردن	/ɡomɒːn boɾdæn/
گمان بردن	/ɡomɒːnboɾdæn/
گمان زدن	/ɡomɒːnzædæn/
گمان  کردن	/ɡomɒːnkæɾdæn/
گمان کردن	/ɡomɒːn kæɾdæn/
گمانه	/ɡomɒːne/
گمانه زدن	/ɡomɒːnezædæn/
گم کردن	/ɡom kæɾdæn/
گناه	/ɡonɒːh/
گناهکار	/ɡonɒːhkɒːɾ/
گناه کبیره	/ɡonɒːhe kæbiːɾe/
گناه کردن	/ɡonɒːhkæɾdæn/
گنبد	/ɡonbæd/
گنجشک	/ɡond͡ʒeʃk/
گنجینه	/ɡænd͡ʒiːne/
گنجه	/ɡænd͡ʒe/
گند	/ɡænd/
گند زدن	/ɡændzædæn/
گند کشیدن	/ɡændkeʃiːdæn/
گندم	/ɡændom/
گندمی	/ɡændomiː/
گنیس	/ɡnejs/
گنگ	/ɡænɡ/
گنگ	/ɡonɡ/
گنوستیسیزم	/ɡnostiːsiːzm/
گنوستیک	/ɡnostiːk/
گه	/ɡoh/
گیهان	/ɡeiːhɒːn/
گهگاه	/ɡæhɡɒːh/
گو	/ɡoʊ/
گو	/ɡuː/
گویان	/ɡuːjɒːn/
گواهی‌نامه رانندگی	/ɡovɒːhiːnɒːmeje ɾɒːnændeɡiː/
گواوا	/ɡvɒːvɒː/
گوته	/ɡote/, /ɡuːte/
گوجه	/ɡoʊd͡ʒe/
گوجه	/ɡod͡ʒe/
گوجه فرنگی	/ɡod͡ʒe fæɾænɡiː/
گود	/ɡoʊd/
گود افتادن	/ɡoʊdoftɒːdæn/
گودال	/ɡouːdɒːl/
گوراسب	/ɡuːɾɒːsb/
گورخر	/ɡuːɾexæɾ/
گورستان	/ɡuːɾestɒːn/
گورکن	/ɡuːɾkæn/
گوریل	/ɡoɾiːl/
گوز	/ɡuːz/
گوزن	/ɡævæzn/
گوساله	/ɡuːsɒːle/
گوسفند	/ɡosfænd/
گوسفند	/ɡuːsfænd/
گوش	/ɡuːʃ/
گویش	/ɡuːjeʃ/
گوشت	/ɡoʃt/
گوشت	/ɡuːʃt/
گوشتخوار	/ɡuːʃtxɒːɾ/
گوش دادن	/ɡuːʃ dɒːdæn/
گوش دادن	/ɡuːʃdɒːdæn/
گوش رسیدن	/ɡuːʃɾesiːdæn/
گوش کردن	/ɡuːʃ kæɾdæn/
گوش کردن	/ɡuːʃkæɾdæn/
گوشمالی دادن	/ɡuːŝmɒːliː dɒːdæn/
گوشه	/ɡuːʃe/
گوشه و کنایه	/ɡuːʃe o kenɒːje/
گوشه و کنایه زدن	/ɡuːʃeokenɒːjezædæn/
گول	/ɡuːl/
گولاگ	/ɡuːlɒːɡ/
گول خوردن	/ɡuːlxoɾdæn/
گول زدن	/ɡuːlzædæn/
گیومه	/ɡiːjuːme/
گونیا	/ɡuːniːjɒː/
گوندولا	/ɡondolɒː/
گونه	/ɡuːnæ/
گونه	/ɡuːne/
گیوه	/ɡiːve/
گویه	/ɡuːje/
گوهر	/ɡohæɾ/
گياه	/ɡiːjɒːh/
گير دادن قلاب	/ɡiːɾ dɒːdæne ɢollɒːb/
لاتین	/lɒːtiːn/
لاتویایی	/lɒːtviːjɒːjiː/
لاجوردی	/lɒːd͡ʒevæɾdiː/
لاجورد	/lɒːd͡ʒvæɾd/
لادا	/lɒːdɒː/
لازم	/lɒːzem/
لاس	/lɒːs/
لاستیک	/lɒːstiːk/
لاس زدن	/lɒːszædæn/
لاف	/lɒːf/
لاف زدن	/lɒːfzædæn/
لاک	/lɒːk/
لاک‌پشت	/lɒːkpoʃt/
لاک زدن	/lɒːkzædæn/
لاکشمی	/lɒːkʃmiː/
لال	/lɒːl/
لالمونی	/lɒːlmuːniː/
لالمونی گرفتن	/lɒːlmuːniːɡeɾeftæn/
لاله	/lɒːle/
لاندا	/lɒːndɒː/
لانه	/lɒːne/
لائوس	/lɒːʔos/
لب	/læb/
لبی	/læbiː/
لیبی	/liːbiː/
لباس	/lebɒːs/
لباس شنا	/lebɒːse ʃenɒː/
لبخند	/læbxænd/
لبخند زدن	/læbxændzædæn/
لیبیدو	/liːbiːdo/, /liːbiːduː/
لب زدن	/læbzædæn/
لب گرفتن	/læb ɡeɾeftæn/
لبنان	/lobnɒːn/
لب‌های بزرگ	/læbhɒːje bozoɾɡ/
لب‌های کوچک	/læbhɒːje kuːt͡ʃek/
لپ	/lop/
لپ	/lopp/
لیتر	/liːtɾ/
لیتوانی	/liːtvɒːniː/
لیتوانیایی	/liːtvɒːniːjɒːjiː/
لتونی	/letuːniː/
لثه	/læse/
لثه	/læse/, /lese/
لج	/læd͡ʒ/
لجاجت	/led͡ʒɒːd͡ʒæt/
لجاجت کردن	/led͡ʒɒːd͡ʒætkæɾdæn/
لجام	/led͡ʒɒːm/
لجام زدن	/leɡɒːmzædæn/
لج کردن	/læd͡ʒkæɾdæn/
لجن	/læd͡ʒæn/
لجن زدن	/læd͡ʒænzædæn/
لحظه	/læhze/
لیختن‌اشتاین	/liːxteneʃtɒːjn/
لذت	/lezzæt/
لذت بردن	/lezzætboɾdæn/
لذیذ	/læziːz/
لرز	/læɾz/
لرزیدن	/læɾziːdæn/
لرزش	/læɾzeʃ/
لرز گرفتن	/læɾzɡeɾeftæn/
لیز	/liːz/
لژیون	/leʒiːon/
لیس	/liːs/
لیسبون	/liːsbon/
لیسیدن	/liːsiːdæn/
لیس زدن	/liːszædæn/
لش	/læʃ/
لطفا	/lotfæn/
لطمه	/lætme/
لطمه خوردن	/lætmexoɾdæn/
لطمه زدن	/lætmezædæn/
لعنتی	/læʔnætiː/
لغت‌نامه	/loɢætnɒːme/
لیف	/liːf/
لیف زدن	/liːfzædæn/
لیف کشیدن	/liːfkeʃiːdæn/
لق	/læɢ/
لقب	/læɢæb/
لقب گرفتن	/læɢæbɡeɾeftæn/
لق خوردن	/læɢxoɾdæn/
لق زدن	/læɢzædæn/
لقمه	/loɢme/
لقمه گرفتن	/loɢmeɡeɾeftæn/
لک	/læk/
لک شدن	/lækʃodæn/
لک‌لک	/læklæk/
لکنت	/loknæt/
لکنت افتادن	/loknætoftɒːdæn/
لکهٔ زرد	/lækkeje zæɾd/
لگام	/leɡɒːm/
لگام زدن	/led͡ʒɒːmzædæn/
لگد	/læɡæd/
لگد خوردن	/læɡædxoɾdæn/
لگد زدن	/læɡædzædæn/
لگد کردن	/læɡædkæɾdæn/
لگو	/leɡuː/, /leɡo/
لمباندن	/lombɒːndæn/
لمس	/læms/
لمس کردن	/læms kæɾdæn/
لیمو	/liːmuː/
لیمویی	/liːmuːjiː/
لیموترش	/liːmuːtoɾʃ/
لیمون	/liːmuːn/
لندن	/lændæn/
لندن بزرگ	/lændæne bozoɾɡ/
لنز	/lenz/
لنز گذاشتن	/lenzɡozɒːʃtæn/
لینکلن	/liːnkoln/
لنگ	/lænɡ/
لنگرگاه	/lænɡæɾɡɒːh/
لنگ زدن	/lænɡzædæn/
لهجه	/læhd͡ʒe/
لهستان	/læhestɒːn/
لهستانی	/lehestɒːniː/
له له	/læhlæh/
له له زدن	/læhlæhzædæn/
لو	/loʊ/
لواش	/lævɒːʃ/
لیوان	/liːvɒːn/
لوبیا	/luːbiːjɒː/
لوت	/luːt/
لوتوس	/lotuːs/
لو دادن	/loʊdɒːdæn/
لیورپول	/liːvæɾpuːl/
لو رفتن	/loʊɾæftæn/
لوزون	/luːzon/
لوکزامبورگ	/luːkzɒːmbuːɾɡ/
لوله‌کش	/luːlekeʃ/
لوور	/luːvɾ/
می	/mej/
ما	/mɒː/
مایا	/mɒːjɒː/
مات	/mɒːt/
ماتروشکا	/mɒːtɾuːʃkɒː/
مات زدن	/mɒːtzædæn/
ماتیک	/mɒːtiːk/
مات کردن	/mɒːt kæɾdæn/
ماتیک زدن	/mɒːtiːkzædæn/
ماتم	/mɒːtæm/
ماتم گرفتن	/mɒːtæmɡeɾeftæn/
ماجورو	/mɒːd͡ʒoɾo/
ماچ	/mɒːt͡ʃ/
ماچ کردن	/mɒːt͡ʃ kæɾdæn/
ماچ کردن	/mɒːt͡ʃkæɾdæn/
ماچین	/mɒːt͡ʃiːn/
مادام	/mɒːdɒːm/
مادر	/mɒːdæɾ/
مادراندر	/mɒːdæɾændæɾ/
مادربزرگ	/mɒːdæɾbozoɾɡ/
مادرجد	/mɒːdæɾd͡ʒædd/
مادر جنده	/mɒːdæɾ d͡ʒende/
مادرخوانده	/mɒːdæɾxwɒːnde/
مادرزن	/mɒːdæɾzæn/
مادرشوهر	/mɒːdæɾʃoʊhæɾ/
مادّه	/mɒːdde/
ماده تاریک	/mɒːddeje tɒːɾiːk/
ماده‌خوک	/mɒːdexuːk/
ماده‌گاو	/mɒːdeɡɒːv/
مار	/mɒːɾ/
ماراتی	/mæɾɒːtiː/
ماریجوانا	/mɒːɾiːxuːɒːnɒː/
مارچوبه	/mɒːɾt͡ʃuːbe/
مارخوار	/mɒːɾxɒːɾ/
مارخور	/mɒːɾxoɾ/
مار زدن	/mɒːɾzædæn/
مارس	/mɒːɾs/
مارک	/mɒːɾk/
مارکس	/mɒːɾks/
مارگارین	/mɒːɾɡɒːɾiːn/
مارماهی	/mɒːɾmɒːhiː/
مارمولک	/mɒːɾmolæk/
مارمولک	/mɒːɾmuːlæk/
مارى	/mɒːɾiː/
مازندران	/mɒːzændæɾɒːn/
ماژیک	/mɒːʒiːk/
ماساژ	/mɒːsɒːʒ/
ماسا�� دادن	/mɒːsɒːʒdɒːdæn/
ماست	/mɒːst/
ماسک	/mɒːsk/
ماسک زدن	/mɒːskzædæn/
ماسه	/mɒːse/
ماسه بادی	/mɒːsse bɒːdiː/
ماشین	/mɒːʃiːn/
ماشین پارک	/mɒːʃiːne pɒːɾk/
ماشین حساب	/mɒːʃiːne hesɒːb/
ماشین‌حساب	/mɒːʃiːnhesɒːb/
ماشین زدن	/mɒːʃiːnzædæn/
ماشين برقي	/mɒːʃiːne bæɾɢiː/
ماضی	/mɒːziː/
مایع	/mɒːjeʔ/
ماک	/mɒːk/
ماکارونی	/mɒːkɒːɾoniː/
ماکائو	/mɒːkɒːo/
مایکروسافت	/mɒːjkɾosoft/
مایکوپ	/mɒːjkuːp/
ماگادان	/mɒːɡɒːdɒːn/
ماگاس	/mɒːɡɒːs/
ماگنیتوگورسک	/mɒːɡniːtuːɡuːɾsk/
مالی	/mɒːliː/
مالایی	/mɒːlɒːjiː/
مالیات	/mɒːliːjɒːt/
مالاریا	/mɒːlɒːɾjɒː/
مالت	/mɒːlt/
مالدار	/mɒːldɒːɾ/
مالدیو	/mɒːldiːv/
مالزی	/mɒːleziː/
مالزیایی	/mɒːleziːjɒːjiː/
مالش	/mɒːleʃ/
مالش دادن	/mɒːleʃdɒːdæn/
مامان	/mɒːmɒːn/
ماموت	/mɒːmuːt/
ماموریت	/mæʔmuːɾiːæt/
ماموریت گرفتن	/mæʔmuːɾiːætɡeɾeftæn/
میان	/miːjɒːn/
میان	/miːɒːn/
میانبر	/miːɒːnboɾ/
میانبر زدن	/miːɒːnboɾzædæn/
ماندارین	/mɒːndɒːɾiːn/
ماندگاری	/mɒːndeɡɒːɾiː/
ماندن	/mɒːndæn/
میاندوراه	/miːjɒːndoɾɒːh/
مانگا	/mɒːnɡɒː/
میان گذاشتن	/miːɒːnɡozɒːʃtæn/
میانمار	/mjɒːnmɒːɾ/
مانند	/mɒːnænd/
میانه	/miːjɒːne/
ماه	/mɒːh/
ماهی	/mɒːhiː/
ماه آینده	/mɒːhe ɒːjænde/
ماهی تابه	/mɒːhiːtɒːbe/
ماهیچه	/mɒːhiːt͡ʃe/
ماهی‌فروش	/mɒːhiːfoɾuːʃ/
ماهی قرمز	/mɒːhiːje ɢeɾmez/
ماه گذشته	/mɒːhe ɡozæʃte/
ماهی مرکب	/mɒːhiːje mæɾkæb/
مایونز	/mɒːjonez/
مائوری	/mɒːʔoɾiː/
مائوئیسم	/mɒːʔuːʔiːsm/
مبارزه	/mobɒːɾeze/
مبارزه کردن	/mobɒːɾezekæɾdæn/
مبارک باشه	/mobɒːɾæk bɒːʃe/
مبالغه	/mobɒːleɢe/
مبالغه کردن	/mobɒːleɢekæɾdæn/
مباهات	/mobɒːhɒːt/
مباهات کردن	/mobɒːhɒːtkæɾdæn/
مبتذل	/mobtæzæl/
مبل	/mobl/
مبلمان	/moblemɒːn/
می بینمت	/miː biːnæmet/
مبهم	/mobhæm/
متی	/mætiː/
متا	/metɒː/
متأسف‌ام	/motæʔsefæm/
متاسفانه	/motæʔæssefɒːne/
متحد	/mottæhed/
متد	/metod/
متر	/metɾ/
مترادف	/motæɾɒːdef/
مترجم	/motæɾd͡ʒem/
متریک	/metɾiːk/
متشکرم	/moteʃækeɾæm/
متغیر	/moteɢejjeɾ/
متغیر عضو	/moteɢejjeɾe ozv/
متن	/mætn/
متن ادبی	/mætne ædæbiː/
مته	/mæte/
متوجه شدید	/motevæd͡ʒd͡ʒe ʃodiːd/
میتوکندری	/miːtokondɾiː/
مثال	/mesɒːl/
مثال زدن	/mesɒːlzædæn/
مثانه	/mæssɒːne/
مثل	/mesle/
مثلا	/mæsælæn/
مثلث	/mosælæs/
مثلثات	/mosælæsɒːt/
مجار	/mæd͡ʒɒːɾ/
مجاری	/mæd͡ʒɒːɾiː/
مجارستان	/mæd͡ʒɒːɾestɒːn/
مجارستانی	/mæd͡ʒɒːɾestɒːniː/
مجازی	/mæd͡ʒɒːziː/
مجازات	/mod͡ʒɒːzɒːt/
مجازات شدن	/mod͡ʒɒːzɒːtʃodæn/
مجازات کردن	/mod͡ʒɒːzɒːtkæɾdæn/
مجانی	/mæd͡ʒd͡ʒɒːniː/
مجاهد	/mod͡ʒɒːhed/
مجاور	/mod͡ʒɒːveɾ/
مجروح	/mæd͡ʒɾuːh/
مجلس	/mæd͡ʒles/
مجله	/mæd͡ʒælle/
مجنون	/mæd͡ʒnuːn/
مجهول	/mæd͡ʒhuːl/
مجوسی	/mæd͡ʒuːsiː/
مچ	/mot͡ʃ/
مچ پا	/mot͡ʃe pɒː/
مچ دست	/mot͡ʃe dæst/
مچ گرفتن	/mot͡ʃɡeɾeftæn/
محاصره	/mohɒːseɾe/
محاصره شدن	/mohɒːseɾeʃodæn/
محاصره کردن	/mohɒːseɾekæɾdæn/
محاصره گرفتن	/mohɒːseɾeɡeɾeftæn/
محاکمه	/mohɒːkeme/
محاکمه کردن	/mohɒːkemekæɾdæn/
محبوب	/mæhbuːb/
محتوا	/mohtævɒː/
محراب	/mehɾɒːb/
محصول	/mæhsuːl/
محک	/mæhæk/
محک خوردن	/mæhækxoɾdæn/
محک زدن	/mæhækzædæn/
محک کردن	/mæhækkæɾdæn/
محکمه	/mæhkæme/
محل	/mæhæll/
محل	‎/mæhæll/
محلی	/mæhælliː/
محله	/mæhælle/
محمد	/mohæmmæd/
محو	/mæhv/
محو کردن	/mæhvkæɾdæn/
میخ	/miːx/
میخی	/miːxiː/
مخاچ‌قلعه	/mæxɒːt͡ʃɢælʔe/
مخاطب	/moxɒːtæb/
مخالف	/moxɒːlef/
مخالفت	/moxɒːlefæt/
مخالفت کردن	/moxɒːlefætkæɾdæn/
مخده	/mæxæddæh/
میخ زدن	/miːxzædæn/
مخصوصا	/mæxsuːsæn/
مخفی	/mæxfiː/
مخفي	/mæxfiː/
می‌خواست	/míxɒːst/
می‌خواستی	/míxɒːstiː/
می‌خواستید	/míxɒːstiːd/
می‌خواستم	/míxɒːstæm/
می‌خواستیم	/míxɒːstiːm/
می‌خواستند	/míxɒːstænd/
می‌خواهی	/míxɒːhiː/
می‌خواهد	/míxɒːhæd/
می‌خواهید	/míxɒːhiːd/
می‌خواهم	/míxɒːhæm/
می‌خواهیم	/míxɒːhiːm/
می‌خواهند	/míxɒːhænd/
مد	/mod/
مداد	/medɒːd/
مداد رنگی	/medɒːde ɾænɡiː/
مداد شمعی	/medɒːde ʃæmʔiː/
مداد نوکی	/medɒːde nokiː/
مدال	/medɒːl/
مدال طلا	/medɒːl e tælɒː/
میدان	/mejdɒːn/
میدان سرخ	/mejdɒːne soɾx/
مدت	/moddæt/
مدخل	/mædxæl/
مدد	/mædæd/
مدد گرفتن	/mædædɡeɾeftæn/
مدیر	/modiːɾ/
مدرسه	/mædɾese/
مدفوع	/mædfuːʔ/
مدور	/modævvæɾ/
مذی	/mæziː/
مذبح	/mæzbæh/
مذهب	/mæzhæb/
مذهب بودا	/mæzhæbe buːdɒː/
میر	/miːɾ/
م‍ﮩ‍ر	/mohoɾ/
مرا	/mæɾɒː/
مراعات	/moɾɒːʔɒːt/
مراعات کردن	/moɾɒːʔɒːtkæɾdæn/
مراکش	/mæɾɒːkeʃ/
مراکشی	/mæɾɒːkeʃiː/
مربع	/moɾæbæ/
مرجان	/mæɾd͡ʒɒːn/
مرحله	/mæɾhæle/
مریخ	/meɾɾiːx/
مریخی	/meɾɾiːxiː/
مرخصی	/moɾæxxæsiː/
مرخصی گرفتن	/moɾæxxæsiːɡeɾeftæn/
مرد	/mæɾd/
مرداد	/moɾdɒːd/
مردانگی	/mæɾdɒːneɡiː/
مردانه	/mæɾdɒːnæ/
مردانه	/mæɾdɒːne/
مردگی	/moɾdeɡiː/
مردم	/mæɾdom/
مردمسالاری	/mæɾdomsɒːlɒːɾiː/
مردم‌سالاری	/mæɾdomsɒːlɒːɾiː/
مردم‌شناسی	/mæɾdomʃenɒːsiː/
مردمک	/mæɾdomæk/
مردن	/moɾdæn/
مردن زدن	/moɾdænzædæn/
مرده	/moɾde/
مرسی	/meɾsiː/
مرض	/mæɾæz/
مریض	/mæɾiːz/
مرض قند	/mæɾæze ɢænd/
مرغ	/moɾɢ/
مرغابی	/moɾɢɒːbiː/
مرغابی جره	/moɾɢɒːbiːje d͡ʒæɾɾe/
مرغ خانگی	/moɾɢe xɒːneɡiː/
مرغ مگس‌خوار	/moɾɢe mæɡæsxɒːɾ/
مركزي	/mæɾkæziː/
مرکب	/moɾækkæb/
مرکز	/mæɾkæz/
مرگ	/mæɾɡ/
مریم	/mæɾjæm/
مرمر	/mæɾmæɾ/
مریم مقدس	/mæɾjæme moɢæddæs/
مرموز	/mæɾmuːz/
مرو	/mæɾv/
مروارید	/mæɾvɒːɾiːd/
مرور	/moɾuːɾ/
مرور کردن	/moɾuːɾkæɾdæn/
مرورگر	/moɾuːɾɡæɾ/
مريض	/mæɾiːz/
میز	/miːz/
مزار شریف	/mæzɒːɾe ʃæɾiːf/
میزان	/miːzɒːn/
میزان	/mîzɒːn/
مزد	/mozd/
می زدن	/mejzædæn/
مزرعه	/mæzɾæʔe/
مزمور	/mæzmuːɾ/
مژه	/moʒe/
مژه زدن	/moʒezædæn/
مس	/mes/
مسی	/mesiː/
مسابقه	/mosɒːbeɢe/
مسابقه دادن	/mosɒːbeɢedɒːdæn/
مسافر	/mosɒːfeɾ/
مسافرت کردن	/mosɒːfeɾæt kæɾdæn/
مسافرخانهچی	/mosæfeɾxɒːneht͡ʃiː/
مست	/mæst/
مستی	/mæstiː/
مستاجر	/mostɒːʔd͡ʒeɾ/
مست تلو تلو خوردن سست	/sost mæst/
مستی زدن	/mæstiːzædæn/
مستقل	/mostæɢel/
مستند	/mostænæd/
مستندات	/mostænædɒːt/
مسجد	/mæsd͡ʒed/
مسیح	/mæsiːh/
مسیحی	/mæsiːhiː/
مسیحیت	/mæsiːhiːjæt/
مسکه	/mæske/
مسکو	/moskuː/
مسلخ	/mæslæx/
مسلسل	/mosælsæl/
مسلسل گاتلینگ	/mosælsæl ɡɒːtliːnɡ/
مسلمان	/mosælmɒːn/
مسلمانی	/mosælmɒːniː/
مسلمون	/mosælmuːn/
مسین	/mesiːn/
مسواک	/mesvɒːk/
مسواک زدن	/mesvɒːkzædæn/
مسواک کردن	/mesvɒːkkæɾdæn/
مسئله	/mæsæle/
مش	/meʃ/
میش	/miːʃ/
مشابه	/moʃɒːbe/
مشام	/mæʃɒːm/
مشام زدن	/mæʃɒːmzædæn/
مشاهده	/moʃɒːhede/
مشاهده کردن	/moʃɒːhedekæɾdæn/
مشت	/moʃt/
مشتاق بودن	/moʃtɒːɢ buːdæn/
مشت خوردن	/moʃtxoɾdæn/
مشتری	/moʃtæɾiː/
مشت زدن	/moʃtzædæn/
مشتق	/moʃtæɢ/
مشتق گرفتن	/moʃtæɢɡeɾeftæn/
مشرق	/mæʃɾeɢ/
مشروب	/mæʃɾuːb/
مش زدن	/meʃzædæn/
مشغول	/mæʃɢuːl/
مشق	/mæʃɢ/
مشکی	/meʃkiː/
مشک	/moʃk/
مش کردن	/meʃkæɾdæn/
مشکل	/moʃkel/
مشیمیه	/mæʃiːmiːje/
مشنگ	/mæʃænɡ/
مشهد	/mæʃhæd/
مصاحبه	/mosɒːhebe/
مصاحبه کردن	/mosɒːhebekæɾdæn/
مصادره	/mosɒːdeɾe/
مصر	/mesɾ/
مصرف کننده	/mæsɾæfe konænde/
مضراب	/mezɾɒːb/
مطاله	/motɒːle/
مطاله کردن	/motɒːle kæɾdæn/
مطب	/mætæb/
مطب زدن	/mætæbzædæn/
مطبوعات	/mætbuːʔɒːt/
مطمئن	/motmæʔenn/, /motmæʔen/
مظلومیت	/mæzluːmiːæt/
مظلومیت زدن	/mæzluːmiːætzædæn/
معادله	/moʔɒːdele/
معیار	/meʔjɒːɾ/
معاشرت	/moʔɒːʃeɾæt/
معاشرت کردن	/moʔɒːʃeɾætkæɾdæn/
معاصر	/moʔɒːseɾ/
معالجه	/moʔɒːled͡ʒe/
معالجه شدن	/moʔɒːled͡ʒeʃodæn/
معالجه کردن	/moʔɒːled͡ʒekæɾdæn/
معامله	/moʔɒːmele/
معامله زدن	/moʔɒːmelezædæn/
معاینه	/moʔɒːjene/
معاینه کردن	/moʔɒːjenekæɾdæn/
معاهده	/moʔɒːhæde/
معتاد	/motɒːd/
معتبر	/moʔtæbæɾ/
معجزه	/moʔd͡ʒeze/
معجزه‌آسا	/moʔd͡ʒezeɒːsɒː/
معدنی	/mæʔdæniː/
معده	/meʔde/
معذرت می‌خواهم	/mæʔzeɾæt miːxɒːhæm/
معرفی	/moʔæɾɾefiː/
معرفت	/mæʔɾefæt/
معرفی شدن	/moʔæɾɾefiːʃodæn/
معرفی کردن	/moʔæɾɾefiːkæɾdæn/
معشوق	/mæʔʃuːɢ/
معشوقه	/mæʔʃuːɢe/
معلق	/mællæɢ/, /moʔællæɢ/
معلق زدن	/mællæɢzædæn/
معلم	/moʔællem/
معلّم	/moællem/
معلوم	/mæʔluːm/
معمار	/meʔmɒːɾ/
معماری	/meʔmɒːɾiː/
معمول	/mæʔmuːl/
معمولی	/mæʔmuːliː/
معمولا	/mæʔmuːlæn/
معنی	/mæʔniː/
معنی‌شناسی	/mæʔniːʃenɒːsiː/
معنی کردن	/mæʔniːkæɾdæn/
مغ	/moɢ/
مغاره	/mæɢɒːɾe/
مغازه	/mæɢɒːze/
مغازه زدن	/mæɢɒːzezædæn/
مغرب	/mæɢɾeb/
مغرب عربی	/mæɢɾeb ʔæɾæbiː/
مغرور	/mæɢɾuːɾ/
مغز	/mæɢz/
مغولی	/moɢuːliː/
مغولستان	/moɢolestɒːn/
مفت	/moft/
مفتی	/moftiː/
مفید	/mofiːd/
مفصل	/mæfsæl/
مفعول	/mæfʔuːl/
مفقود	/mæfɢuːd/
مفهوم	/mæfhuːm/
مقیاس ریشتر	/meɢjɒːs ɾiːʃteɾ/
مقایسه	/moɢɒːjese/
مقایسه کردن	/moɢɒːjesekæɾdæn/
مقاله	/mæɢɒːle/
مقام	/mæɢɒːm/
مقدار	/meɢdɒːɾ/
مقدار زیاد	/meɢdɒːɾe ziːjɒːd/
مقدس	/moɢæddæs/
مقدمه	/moɢæddæme/
مقدونی	/mæɢduːniː/
مقدونیه	/mæɢduːniːje/
مقعد	/mæɢʔæd/
مقعدی	/mæɢʔædiː/
مک	/mek/
مکاتبه	/mokɒːtebe/
مکاتبه داشتن	/mokɒːbebedɒːʃtæn/
مکادونی	/mækɒːduːniː/
مکادونیه	/mækɒːduːniːje/
میکاییل	/miːkɒːjiːl/
میکال	/miːkɒːl/
مکان	/mækɒːn/
مکانیک	/mekɒːniːk/
مکانیک کوانتوم	/mekɒːniːke kvɒːntuːm/
مکان‌ها	/mækɒːnhɒː/
میکائیل	/miːkɒːʔiːl/
مکیدن	/mækiːdæn/
مک‌دونالدز	/mækdonɒːldz/
میکرب	/miːkɾob/
مک زدن	/mekzædæn/
مکزیک	/mekziːk/
مکعب	/mokæʔæb/
مکعب روبیک	/mokæʔæbe ɾuːbiːk/
مکه	/mække/
مگر	/mæɡæɾ/
مگس	/mæɡæs/
مگس انگبین	/mæɡæsænɡæbiːn/
میگو	/mejɡuː/
میل	/mejl/
ملاحظه	/molɒːheze/
ملاحظه فرمودن	/molɒːhezekæɾdæn/
ملافه	/mælɒːfe/
ملاقات	/molɒːɢɒːt/
ملاقات کردن	/molɒːɢɒːtkæɾdæn/
ملال آور	/mælɒːlɒːvæɾ/
ملیت	/melliːjjæt/
ملخ	/mælæx/
ملخ زدن	/mælæxzædæn/
میل زدن	/mejlzædæn/
میل کردن	/mejlkæɾdæn/
میلک شیک	/miːlk ʃejk/
میلیون	/miːljon/
میلیون	/miːljuːn/
ممکن	/momken/
ممنوع	/memnuː/
ممنوع است	/memnuː æst/
ممنون	/mæmnuːn/
ممنونم	/mæmnúnæm/
میمون	/mejmuːn/
میمون	/mejmuːn/, /mejmuːn/
یمن	/jæmæn/
من	/mæn/
منی	/mæniː/
مین	/miːn/
منی	/moniː/
منار	/menɒːɾ/
مناره	/menɒːɾe/
منبع	/mænbæ/
منت	/mennæt/
منتظر شدن	/montæzeɾ ʃodæn/
منچوری	/mænt͡ʃuːɾiː/
منداغان	/mændɒːɢɒːn/
منزل	/mænzel/
منزلت	/mænzelæt/
منزل داشتن	/mænzeldɒːʃtæn/
مینسک	/miːnsk/
منشی	/monʃiː/
منشار	/menʃɒːɾ/
منطق	/mænteɢ/
منظره	/mænzæɾe/
منظومه شمسی	/mænzuːmeʃæmsiː/
منقرض	/monɢæɾez/
منگنز	/mænɡènèz/
منگنه	/mænɡæne/
منگنه زدن	/mænɡænezædæn/
منگنه کردن	/mænɡænekæɾdæn/
مینو	/miːnuː/
مه	/mæh/
مه	/me/
مه	/mə/, /me/
مه	/mɒːh/
مهاجر	/mohɒːd͡ʒeɾ/
مهاجرت	/mohɒːd͡ʒeɾæt/
مهاچین	/mæhɒːt͡ʃiːn/
مهار	/mæhɒːɾ/
مهار زدن	/mæhɒːɾzædæn/
مهار کردن	/mæhɒːɾkæɾdæn/
مهبانگ	/mæhbɒːnɡ/
مهبل	/mæhbæl/
مهتاب	/mæhtɒːb/
مهتر	/mæhtæɾ/
مهتر	/mehtæɾ/
مه تنک	/mee tonok/
مهر	/mehɾ/
مهر	/mohɾ/
مهرابه	/mehɾɒːbe/
مهربان	/mehɾæbɒːn/
مهربانی	/mehɾæbɒːniː/
مهربان	/mehɾæbɒːn/, /mehæɾbɒːn/
مهر خوردن	/mohɾxoɾdæn/
مهر زدن	/mohɾzædæn/
مهر کردن	/mohɾkæɾdæn/
مهره‌دار	/mohɾedɒːɾ/
مهر ورزیدن	/mehɾ væɾziːdæn/
مهم	/mohem/
مهمان	/mehmɒːn/
مهمانی	/mehmɒːniː/
مهمانسرا	/mehmɒːnsæɾɒː/
مهمانی منزل مبارکی	/mehmɒːniːje mænzele mobɒːɾækiː/
میهن	/miːhæn/
مهندس	/mohændes/
مهندسی	/mohændesiː/
میو	/miːjuː/
مو	/mo/
مو	/muː/
موافق بودن	/movɒːfeɢ buːdæn/
میوآن	/mjuːɒːn/
موبایل	/mobɒːiːl/
موبایل	/mobɒːjl/
موت	/mouːt/
موتور	/اسم/
موتورسیکلت	/motoɾsiːklet/
موتورگازی	/motoɾɡɒːziː/
موتورولا	/motoɾolɒː/
موج	/moʊd͡ʒ/
موج زدن	/moʊd͡ʒzædæn/
مؤدب	/moʔæddæb/
مؤذن	/moʔæzzen/
مور	/muːɾ/
موریانه	/muːɾiːjɒːne/
مورچه	/muːɾt͡ʃe/
مورمانسک	/muːɾmɒːnsk/
موز	/mouːz/
موز	/moʊz/
موزامبیک	/muːzɒːmbiːk/
مو زدن	/muːzædæn/
موزیک	/muːziːk/
موزه	/muːze/
موی زهار	/muːj e zæhɒːɾ/
موژیک	/muːʒiːk/
موس	/moʊs/
موسی	/muːsɒː/
موس	/muːs/
موسیقی	/muːsiːɢiː/
موسم	/mæuːsæm/
موسولینی	/muːsuːliːniː/
موش	/muːʃ/
موشی	/muːʃiː/
موش شبگرد	/muːʃe ʃæbɡæɾd/
موشک	/muːʃæk/
موشکافی کردن	/muːŝekɒːfiː kæɾdæn/
موشک خوردن	/muːʃækxoɾdæn/
موشک زدن	/muːʃækzædæn/
موش‌مردگی	/muːʃmoɾdeɡiː/
موش‌مردگی زدن	/muːʃmoɾdeɡiːzædæn/
موشواره	/muːʃvɒːɾæ/
موضوع	/moʊzuː/
موعظه	/moʔeze/
موعظه کردن	/moʔezekæɾdæn/
موفق باشی	/movæffæɢ bɒːʃiː/
موفق باشید	/movæffæɢ bɒːʃiːd/
مولداوی	/muːldɒːviː/
مؤلف	/moʔællef/
مولکول	/molekuːl/
موم	/muːm/
مومیا	/muːmjɒː/
موم عسل	/muːm æsæl/
مونته‌نگرو	/monteneɡɾuː/
مونیخ	/muːniːx/
میوه	/miːve/
ميانه	/miːjɒːnæ/, /miːjɒːne/
مياني	/miːjɒːniː/
ميليارد	/miːljɒːɾd/
نی	/nej/
نای	/nɒːj/
نایاب	/nɒːjɒːb/
ناامید	/næomiːd/
ناب	/nɒːb/
نابرادری	/nɒːbæɾɒːdæɾiː/
نابکار	/nɒːbekɒːɾ/
نابینا	/nɒːbiːnɒː/
نابینایی	/nɒːbiːnɒːjiː/
نابه هنگام	/nɒːbehænɡɒːm/
نابودی	/nɒːbuːdiː/
نابود کردن	/nɒːbuːd kæɾdæn/
نایپیداو	/nɒːjpiːdɒːv/
ناپدری	/nɒːpedæɾiː/
ناپسری	/nɒːpesæɾiː/
ناتاراجا	/nɒːtɒːɾɒːd͡ʒɒː/
ناتنی	/nɒːtæniː/
ناتو	/nɒːto/
ناجور	/nɒːd͡ʒuːɾ/
ناخدا	/nɒːxodæ/
ناخن	/nɒːxon/
ناخن زدن	/nɒːxonzædæn/
ناخنک 	/nɒːxonæk/
ناخنک	/nɒːxonæk/
ناخنک  زدن	/nɒːxonækzædæn/
ناخن کشیدن	/nɒːxonzædæn/
ناخنک کردن	/nɒːxonækkæɾdæn/
ناخواهری	/nɒːxwɒːhæɾiː/
ناخوشی	/nɒːxoʃiː/
ناخوشی	/nɒːxuːʃiː/
ناخوشایند	/nɒːxuːʃɒːjænd/
ناخوشی زدن	/nɒːxoʃiːzædæn/
نادیا	/nɒːdiːjɒː/
نادانی	/nɒːdɒːniː/
نادانی زدن	/nɒːdɒːniːzædæn/
نادختری	/nɒːdoxtæɾiː/
نادر	/nɒːdeɾ/
نارسا گویی	/nɒːɾæsɒː ɡuːjiː/
نارگیل	/nɒːɾɡiːl/
نارگیله	/nɒːɾɡiːle/
نارنج	/nɒːɾænd͡ʒ/
نارنجی	/nɒːɾænd͡ʒiː/
نارنج	/nɒːɾend͡ʒ/
نارنجی	/nɒːɾend͡ʒiː/
نارنجی سیر	/nɒːɾend͡ʒiː siːɾ/
نارنجک	/nɒːɾend͡ʒæk/
نارنگ	/nɒːɾænɡ/, /nɒːɾenɡ/
نارنگی	/nɒːɾenɡiː/
نارو	/nɒːɾo/
نارو خوردن	/nɒːɾoxoɾdæn/
نارو زدن	/nɒːɾozædæn/
نیاز	/niːjɒːz/
ناز	/nɒːz/
نازی	/nɒːziː/
نازیسم	/nɒːziːsæm/
نازک	/nɒːzek/
نازنین	/nɒːzæniːn/
ناسا	/nɒːsɒː/
ناسازگار	/nɒːsɒːzɡɒːɾ/
ناسازگاری	/nɒːsɒːzɡɒːɾiː/
نیایش	/niːjɒːjeʃ/
ناشایست	/nɒːʃɒːjest/
ناشتا	/nɒːʃtɒː/
ناشنوا	/nɒːʃenævɒː/
ناف	/nɒːf/
نافرمان	/nɒːfæɾmɒːn/
نافرمانی	/nɒːfæɾmɒːniː/
ناقص	/nɒːɢes/
ناكار	/nɒːkɒːɾ/
ناکارامد	/nɒːkɒːɾɒːmæd/
ناکافی	/nɒːkɒːfiː/
ناگازاکی	/næɡæzɒːkiː/
ناگهان	/nɒːɡæhɒːn/
نالیدن	/nɒːliːdæn/
ناله	/nɒːlæ/
ناله	/nɒːlæ/, /nɒːle/
ناله	/nɒːle/
ناله زدن	/nɒːlezædæn/
ناله کردن	/nɒːlekæɾdæn/
ناله کشیدن	/nɒːlekeʃiːdæn/
نایلون	/nɒːjlon/
نام	/nɒːm/
نامادری	/nɒːmɒːdæɾiː/
نام‌آوا	/nɒːmɒːvɒː/
نامبردن	/nɒːmboɾdæn/
نام خانوادگی	/nɒːme xɒːnevɒːdeɡiː/
نامیدن	/nɒːmiːdæn/
نامزد	/nɒːmzæd/
نامزدن	/nɒːmzædæn/
نامک	/nɒːmæk/
نامه	/nɒːme/
نامه به افسسیان	/næmh bh æfssɒːn/
نام‌واژه	/nɒːmvɒːʒe/
نامْور	/nɒːmvæɾ/
نان	/nɒːn/
نان تست	/nɒːne tost/
نانوا	/nɒːnvɒː/
نانوایی	/nɒːnvɒːjiː/
نانوائی	/nɒːnvɒːʔiː/, /nɒːnevɒːʔiː/
ناهار	/nɒːhɒːɾ/
ناهید	/nɒːhiːd/
ناهمگون	/nɒːhæmɡuːn/
نیاهندوایرانی	/niːjɒːhendoiːɾɒːniː/
نیاهندواروپایی	/niːjɒːhendooɾuːpɒːjiː/
نیاهندو‌اروپایی	/niːjɒːhendooɾuːpɒːjiː/
نیاهندواروپایی‌زبان	/niːjɒːhendooɾuːpɒːjiːzæbɒːn/
ناو	/nɒːv/
ناواهو	/nɒːvɒːho/
نبرد	/næbæɾd/
نبیره	/næbiːɾe/
نبض	/næbz/
نبض گرفتن	/næbzɡeɾeftæn/
نپال	/nepɒːl/
نتیجه	/nætiːd͡ʒe/
نیتریک اسید	/niːtɾiːk æsiːd/
نجات	/ned͡ʒɒːt/
نجات دادن	/ned͡ʒɒːtdɒːdæn/
نجّار	/næd͡ʒd͡ʒɒːɾ/
نجیب	/næd͡ʒiːb/
نیجر	/niːd͡ʒeɾ/
نیجریه	/niːd͡ʒeɾiːje/
نجم	/næd͡ʒm/
ینی‌چری	/jeniːt͡ʃeɾiː/
نحو	/næhv/
نخجوان	/næxd͡ʒevɒːn/
نخیر	/næxejɾ/
نخست	/noxost/
نخستین	/noxostiːn/
نخست وزیر	/noxost væziːɾ/
نخود	/noxod/
ندا	/nedɒː/
ندیده	/nædiːde/
نر	/næɾ/
نراد	/næɾɒːd/
نرد	/næɾd/
نردبان	/næɾdæbɒːn/, /næɾdebɒːn/, /næɾdobɒːn/
نرگس	/næɾɡes/
نرم	/næɾm/
نرم‌افزار	/næɾmæfzɒːɾ/
نرم‌تن	/næɾmtæn/
نرمهٔ گوش	/næɾmeje ɡuːʃ/
نیرنگ	/nejɾænɡ/
نیرنگباز	/nejɾænɡbɒːz/
نیرنگ زدن	/nejɾænɡzædæn/
نیروی برانگیزنده	/niːɾuːje bæɾɒːnɡiːzænde/
نیروی دریایی	/niːɾuːjedæɾjɒːjiː/
نروژ	/noɾveʒ/
نیروگاه	/niːɾuːɡɒːh/
نیروی هوائی	/niːɾuːje hævɒːjiː/
نیز	/niːz/
نزد	/næzd/
نزدیک	/næzdiːk/
نزدیکان	/næzdiːkɒːn/
نزدیک شدن	/næzdiːk ŝodæn/
نی زدن	/nejzædæn/
نیزه	/nejze/
نیزه‌دار	/nejzedɒːɾ/
نژاد	/neʒɒːd/
نژادی	/neʒɒːdiː/
نژاد برتر	/neʒɒːde bæɾtæɾ/
نژادپرستی	/neʒɒːdpæɾæstiː/
نژاد پرستی	/neʒɒːd pæɾæstiː/
نیس	/niːs/
نسبی	/nesbiː/
نسبت	/nesbæt/
نسبت دادن	/nesbætdɒːdæn/
نستعلیق	/næstæʔliːɢ/
نسخه خطی	/nosxeje xættiː/
نسک	/næsk/
نسل	/næsl/
نیش	/niːʃ/
نشان	/neʃɒːn/
نشان	/neŝɒːn/
نشان دادن	/neʃɒːn dædɒːn/
نشان دادن	/neʃɒːn dɒːdæn/
نشان دادن	/neʃɒːndɒːdæn/
نشان زرین	/neʃɒːn e zæɾiːn/
نشانه	/neʃɒːne/neʃɒːn/
نشانه‌شناسی	/neʃɒːneʃenɒːsiː/
نشانه‌گذاری	/neʃɒːneɡozɒːɾiː/
نشانه‌گذاری شدن	/neʃɒːneɡozɒːɾiːʃodæn/
نشانه‌گذاری کردن	/neʃɒːneɡozɒːɾiːkæɾdæn/
نشانه گرفتن	/neʃɒːneɡeɾeftæn/
نشانه‌های سجاوندی	/neʃɒːnehɒːje sæd͡ʒɒːvændiː/
نیشتر	/niːʃtæɾ/
نیشتر زدن	/niːʃtæɾzædæn/
نیشخند	/niːʃxænd/
نیشخند زدن	/niːʃxændzædæn/
نشریه	/næʃɾiːje/
نشریه زدن	/næʃɾiːjezædæn/
نیش زدن	/niːʃzædæn/
نشست	/neʃæst/
نشستن	/neʃæstæn/
نیشکر	/nejʃækæɾ/
نیشگون	/niːʃɡuːn/
نیشگون گرفتن	/niːʃɡuːnɡeɾeftæn/
نشیمن	/neʃiːmæn/
نشین	/neʃiːn/
نیش و کنایه	/niːʃ o kenɒːje/
نیش و کنایه زدن	/niːʃokenɒːjezædæn/
نصب	/næsb/
نصب شدن	/næsbʃodæn/
نصب کردن	/næsb kæɾdæn/
نصب کردن	/næsbkæɾdæn/
نصیحت	/næsiːhæt/
نصف	/nesf/
نطفه	/notfæ/
نطق	/notɢ/
نطق کردن	/notɢkæɾdæn/
نظاره	/nezɒːɾe/
نظاره کردن	/nezɒːɾekæɾdæn/
نظر	/næzæɾ/
نظر خوردن	/næzæɾxoɾdæn/
نظر داشتن	/næzæɾdɒːʃtæn/
نظر زدن	/næzæɾzædæn/
نظر کردن	/næzæɾkæɾdæn/
نظر گرفتن	/næzæɾɡeɾeftæn/
نظم	/næzm/
نظم دادن	/næzmdɒːdæn/
نعره	/næ’ɾe/
نعره زدن	/næ’ɾezædæn/
نعره کشیدن	/næ’ɾekeʃiːdæn/
نعل	/næʔl/
نعل اسب	/næʔle æsb/
نعلبند	/nælbænd/
نعلچیک	/næʔlt͡ʃiːk/
نعل کردن	/næʔlkæɾdæn/
نعناع	/næʔnɒːʔ/
نعوظ	/noʻuːz/
نفت	/næft/
نفر	/næfæɾ/
نفرت	/næfɾæt/
نفرت داشتن	/nefɾæt dɒːʃtæn/
نفرین	/nefɾiːn/
نفرین ابدی	/nefɾiːne æbædiː/
نفرین کردن	/nefɾiːnkæɾdæn/
نفس	/næfæs/
نفس	/næfs/
نفس زدن	/næfæszædæn/
نفس کشیدن	/næfæskeʃiːdæn/
نفس نفس	/næfæsnæfæs/
نفس نفس زدن	/næfæsnæfæszædæn/
نفهمی	/næfæhmiː/
نفهمی زدن	/næfæhmiːzædæn/
نفوس بد	/nofuːse bæd/
نفوس بد زدن	/nofuːsebædzædæn/
نق	/neɢ/
نقاب	/neɢɒːb/
نقاب زدن	/neɢɒːbzædæn/
نقاد	/næɢɒːd/
نقاش	/næɢɢɒːʃ/
نقّاش	/næɢɢɒːʃ/
نقاشی	/næɢɢɒːʃiː/
نقاشی شدن	/næɢɢɒːʃiːʃodæn/
نقاشی کردن	/næɢɢɒːʃiːkæɾdæn/
نقاله	/næɢɢɒːle/
نقب	/næɢb/
نقب زدن	/næɢbzædæn/
نقد	/næɢd/
نقره	/noɢɾe/
نقره‌ای	/noɢɾeʔiː/
نقره‌ای	/noɢɾejiː/
نقره فام	/noɢɾefæm/
نقره‌فام	/noɢɾefɒːm/
نق زدن	/neɢ zædæn/
نق زدن	/neɢzædæn/
نقش	/næɢʃ/
نقش زدن	/næɢʃzædæn/
نقش کشیدن	/næɢʃkeʃiːdæn/
نقشه	/næɢʃe/
نقشه کشیدن	/næɢʃekeʃiːdæn/
نقصان	/noɢsɒːn/
نقصان یافتن	/noɢsɒːnjɒːftæn/
نقصان گرفتن	/noɢsɒːnɡeɾeftæn/
نقطه	/noɢte/
نقطه‌ی ذوب	/noɢteje zob/
نقطه لاگرانژی	/noɢteje lɒːɡɾɒːnʒiː/
نقطه‌ویرگول	/noɢteviːɾɡuːl/
نقل	/næɢl/
نقلی	/næɢliː/
نقل	/noɢl/
نقل کردن	/næɢlkæɾdæn/
نیک	/niːk/
نکاح	/nekɒːh/
نیکاراگوئه	/niːkɒːɾɒːɡuːʔe/
نیکل	/niːkel/
نکن	/nækon/
نگار	/neɡɒːɾ/
نگاره	/neɡɒːɾæ/, /neɡɒːɾe/
نگاه	/neɡɒːh/
نگاه انداختن	/neɡɒːhændɒːxtæn/
نگاه داشتن	/neɡɒːhdɒːʃtæn/
نگاه دزدانه	/neɡɒːhe dozdɒːnæ/
نگاه کردن	/neɡɒːh kæɾdæn/
نگاه کردن	/neɡɒːhkæɾdæn/
نگاه‌کردن	/neɡɒːhkæɾdæn/
نگران	/neɡæɾɒːn/
نگریستن	/neɡæɾiːstæn/
نگره	/neɡæɾe/
نگهبان	/neɡæhbɒːn/
نگهداری	/neɡæhdɒːɾiː/
نگهداری کردن	/neɡæhdɒːɾiːkæɾdæn/
نگه داشتن	/neɡæh dɒːʃtæn/
نیل	/niːl/
نیلی	/niːliː/
نیلوفر آبی	/niːluːfæɾe ɒːbiː/
نم	/næm/
نیم	/niːm/
نمایاندن	/næmɒːjɒːndæn/
نماد	/næmɒːd/
نماز	/næmɒːz/
نماز خواندن	/næmɒːz xɒːndæn/
نمایش	/næmɒːjeʃ/
نمایشگاه	/næmɒːjeʃɡɒːh/
نمایه	/næmɒːje/
نیم‌خط	/niːmxæt/
نیمروز	/niːmɾuːz/
نم زدن	/næmzædæn/
نیمسال تحصیلی	/niːmsɒːl tæhsiːliː/
نمک	/næmæk/
نیمکت	/niːmkæt/
نم کردن	/næmkæɾdæn/
نمک زدن	/næmækzædæn/
نم کشیدن	/næmkeʃiːdæn/
نمکین	/næmækiːn/
نیمه‌عمر	/niːmeʔomɾ/
نمودار	/nemuːdɒːɾ/
نمودن	/nemuːdæn/
نمونه	/nemuːne/, /nomuːne/
نینجوتسو	/niːnd͡ʒuːtsuː/
ننگ	/nænɡ/
ننگ زدن	/nænɡzædæn/
نینوا	/nejnævɒː/
نه	/næ/
نه	/næh/
نه	/noh/
نهایتا	/næhɒːjætæn/
نهان	/nehɒːn/
نهانی	/nehɒːniː/
نهیب	/næhiːb/
نهیب زدن	/næhiːbzædæn/
نهر	/næhɾ/
نهسد	/nohsæd/
نهصد	/nohsæd/
نهم	/nohom/
نهنگ	/næhænɡ/
نه هزار	/noh hæzɒːɾ/
نو	/noʊ/
نو	/nouː/
نو	/nuː/
نواختر	/nouːæxtæɾ/
نوازش	/nævɒːzeʃ/
نوازش دادن	/nævɒːzeʃdɒːdæn/
نوازش کردن	/nævɒːzeʃkæɾdæn/
نوامبر	/novɒːmbɾ/
نوتلا	/nuːtelɒː/
نود	/nævæd/
نور	/nuːɾ/
نورنبرگ	/nuːɾænbeɾɡ/
نوروز	/nouːɾuːz/
نوزاد	/nouːzɒːd/
نوزده	/nuːzdæh/
نیوزیلند	/niːjuːziːlend/
نویسنده	/neviːsænde/
نویسه	/neviːsæ/
نویسه‌گردانی	/neviːseɡæɾdɒːniː/
نوشابه	/nuːʃɒːbæ/
نوشابه	/nuːʃɒːbe/
نوشابه زدن	/nuːʃæbezædæn/
نوشتن	/næveʃtæn/, /neveʃtæn/
نوشتن	/neveʃtæn/
نوشته	/neveʃte/
نوش جان	/nuːʃe d͡ʒɒːn/
نوشیدن	/nuːʃiːdæn/
نوشیدنی	/nuːʃiːdæniː/
نوشیدنی الکلی	/nuːʃiːdæniːje ælkoliː/
نوع	/noʊʔ/
نوع	/noʊ/, /noʊʔ/
نوک	/nok/
نوکیا	/nuːkiːjɒː/
نوک‌اردکی	/nokoɾdækiː/
نوک پستان	/noke pestɒːn/
نوکر	/nouːkæɾ/
نوک زدن	/nokzædæn/
نوگل	/noʊɡol/
نوین	/noviːn/
نون	/nuːn/
نوه	/næve/
نیویورک	/njuːjuːɾk/
نئره	/næɾe/
نئونازی	/neʔuːnɒːziː/
نيز	/niːz/
یه	/je/
یه ی	/je iː/
ها	/hɒː/
هابیل	/hɒːbiːl/
هات داگ	/hɒːt dɒːɡ/
هاید پارک	/hɒːjd pɒːɾk/
هادرون	/hɒːdɾon/
هادسون	/hɒːdsuːn/
هارد راک	/hɒːɾd ɾɒːk/
هاردکور	/hɒːɾdkoɾ/
هاسی	/hɒːsej/
هاشور	/hɒːʃuːɾ/
هاشور خوردن	/hɒːʃuːɾxoɾdæn/
هاشور زدن	/hɒːʃuːɾzædæn/
هاکی	/hɒːkiː/
هالتر	/hɒːlteɾ/
هالتر زدن	/hɒːlteɾzædæn/
هاله	/hɒːle/
هالو	/hɒːluː/
هالیوود	/hɒːliːvuːd/
هالووین	/hɒːlouːviːn/
هامین	/hɒːmiːn/
هاینه	/hɒːjne/
هانوی	/hɒːnuːj/
هاوانا	/hɒːvɒːnɒː/
هاوائ	/hævɒːiː/
هپاتیت	/hiːpɒːtiːt/
هتل	/hotel/
هیجان	/hæjæd͡ʒɒːn/
هیجان	/hiːd͡ʒɒːn/
هیجان آمدن	/hæjæd͡ʒɒːnɒːmædæn/
هیجان آوردن	/hæjæd͡ʒɒːnɒːvæɾdæn/
هجده	/hed͡ʒdæh/
هیجده	/hiːd͡ʒdæh/
هجوم	/hod͡ʒuːm/
هجوم آوردن	/hod͡ʒuːmɒːvæɾdæn/
هیچ	/hiːt͡ʃ/
هیچ‌چیز	/hiːt͡ʃt͡ʃiːz/
هیچ‌کس	/hiːt͡ʃkæs/
هیچ گرداندن	/hiːt͡ʃ ɡæɾdɒːndæn/
هیچ وقت	/hiːt͡ʃ væɢt/
هخامنشی	/hæxɒːmæneʃiː/
هخامنشیان	/hæxɒːmæneʃiːɒːn/
هدایت	/hedɒːjæt/
هدایت شدن	/hedɒːjætʃodæn/
هدایت کردن	/hedɒːjætkæɾdæn/
هیدروژن	/hiːdɾod͡ʒen/
هیدروژن پراکسید	/hiːdɾoʒen peɾɒːksiːd/
هیدروکلریک اسید	/hiːdɾokoloɾiːk æsiːd/
هیدرولیک	/hiːdɾoliːk/
هیدرولیکی	/hiːdɾoliːkiː/
هدف	/hædæf/
هدیه	/hædiːje/, /hediːje/
هدیه	/hedje/
هدهد	/hod hod/
هدیه کردن	/hedjekæɾdæn/
هر	/hæɾ/
هرات	/heɾɒːt/
هرازدان	/heɾɒːzdɒːn/
هر از گاهی	/hæɾæzɡɒːhiː/
هراس	/hæɾɒːs/
هر چیز	/hæme t͡ʃiːz/
هرچند	/hæɾt͡ʃænd/
هر چند وقت یک بار	/hæɾt͡ʃændvæɢtjekbɒːɾ/
هرچه زودتر	/hæɾt͡ʃe zuːdtæɾ/
هردو	/hæɾdo/
هر دو	/hæɾ do/
هرزه	/hæɾzæ/
هرزه‌نگاری	/hæɾzeneɡɒːɾiː/
هرگز	/hæɾɡez/
هرم بزرگ جیزه	/hæɾæm bozoɾɡ d͡ʒîze/
هیره	/hiːɾe/
هریوا	/hæɾejvɒː/
هزار	/hezɒːɾ/
هزارپا	/hezɒːɾpɒː/
هزاردستان	/hæzɒːɾdæstɒːn/
هزاره	/hezɒːɾe/
هزاره‌ی سوم	/hezɒːɾeje sevvom/
هیزم	/hiːzom/
هسپانیه	/hespɒːniːje/
هستی	/hæsiː/
هست	/hæst/
هستی	/hæstiː/
هستی‌گرایی	/hæstiːɡeɾɒːjiː/
هستم	/hæstæm/
هسته	/hæstæ/, /hæste/
هسته‌ای	/hæsteʔiː/
هش	/hæʃ/
هشیاری	/hoʃjɒːɾiː/
هشت	/hæʃt/
هشتاد	/hæʃtɒːd/
هشت‌پا	/hæʃtpɒː/
هشتسد	/hæʃtsæd/
هشتصد	/hæʃtsæd/
هشتم	/hæʃtom/
هفت	/hæft/
هفتاد	/hæftɒːd/
هفتصد	/hæftsæd/
هفتم	/hæftom/
هفته	/hæfte/
هفته‌ی آینده	/hæfteje ɒːjænde/
هفته‌ی گذشته	/hæfteje ɡozæʃte/
هفده	/hefdæʔ/
هفده	/hefdæh/
هکر	/hækeɾ/
یه کمی	/je kæmiː/
هل	/hel/
هیل	/hiːl/
هیلاری	/hiːlɒːɾiː/
هلال احمر	/helɒːle æhmæɾ/
هلال حاصلخیز	/helɒːlehɒːselxiːz/
هل دادن	/hol dɒːdæn/
هلیکوپتر	/heliːkuːpteɾ/
هلنی	/heleniː/
هلند	/holænd/
هلندی	/holændiː/
هلندی‌ها	/holændiːhɒː/
هله‌لویا	/hæleluːjɒː/
هله‌هوله	/hælehuːle/
هلو	/holuː/
هم	/hæm/
هما	/homɒː/
همایش	/hæmɒːjeʃ/
همانی	/hæmɒːniː/
هماهنگ	/hæmɒːhænɡ/
هماورد	/hæmɒːvæɾd/
همايش	/hæmɒːjeʃ/
همبرگر	/hæmbeɾɡeɾ/
همبستر	/hæmbæstæɾ/
هم​بستر شدن	/hæmbæstæɾ ʃodæn/
همجنس‌گرا	/hæmd͡ʒensɡæɾɒː/
هم‌جنس‌گرایی	/hæmd͡ʒensɡæɾɒːjiː/
همچنین	/hæmt͡ʃeniːn/
همخوابگی	/hæmxɒːbeɡj/
هم خوردن	/hæmxoɾdæn/
همدستی	/hæmdæstiː/
همدستی در جرم	/hæmdæstiː dæɾ d͡ʒoɾm/
همدستی کردن	/hæmdæstiː kæɾdæn/
همرقص	/hæmɾæɢs/
همروزگار	/hæmɾuːzeɡɒːɾ/
همزاد	/hæmzɒːd/
هم زدن	/hæmzædæn/
همزه	/hæmze/
همساخته	/hæmsɒːxtæ/
همسان درمانی	/hæmsɒːn dæɾmɒːniː/
همسایه	/hæmsɒːjæ/, /hæmsɒːje/
همسایه	/hæmsɒːje/
همیستار	/hæmiːstɒːɾ/
همسر	/hæmsæɾ/
همسنجی	/hæmsænd͡ʒiː/
همیشه	/hæmiːʃe/
همکار	/hæmkɒːɾ/
همکاری	/hæmkɒːɾiː/
همکاری کردن	/hæmkɒːɾiːkæɾdæn/
همکلاس	/hæmkelɒːs/
همگام	/hæmɡɒːm/
همگام‌سازی	/hæmɡɒːmsɒːziː/
هملت	/hæmlet/
هم‌معنی	/hæmmæʔniː/
همین	/hæmiːn/
همنژادان	/hæmnæʒɒːdɒːn/
همنوا	/hæmnævɒː/
همنوع‌خواری	/hæmnouːʔxɒːɾiː/
همه	/hæme/
هیمه	/hiːmæ/
همه‌چیز	/hæmet͡ʃiːz/
هموندان	/hæmvændɒːn/
هنباز	/hænbɒːz/
هند	/hend/
هندی	/hendiː/
هندایرانی	/hendiːɾɒːniː/
هندسه	/hendese/
هندسه اقليدسی	/hendese oɢliːdsiː/
هندو	/henduː/
هندوایرانی	/hendoiːɾɒːniː/
هندو‌اروپایی	/hendooɾuːpejiː/
هندوانه	/hendevɒːne/
هندوستان	/henduːstɒːn/
هندوستانی	/henduːstɒːniː/
هندوکش	/henduːkuːʃ/
هنر	/honæɾ/
هنرپیشه	/honæɾpiːʃe/
هنر رزمی	/honæɾe ɾæzmiː/
هنرمند	/honæɾmænd/
هنگامی که	/hænɡɒːmiː ke/
هنگ کنگ	/honɡ konɡ/
هنگ‌کنگ	/honɡkonɡ/
هنوز	/hænuːz/
هوا	/hævɒː/
هواپیما	/hævɒːpejmɒː/
هواپيما	/hævɒːpejmɒː/
هوا دادن	/hævɒː dɒːdæn/
هوادار	/hævɒːdɒːɾ/
هوار	/hævɒːɾ/
هوار زدن	/hævɒːɾzædæn/
هوار کشیدن	/hævɒːɾ keʃiːdæn/
هوار کشیدن	/hævɒːɾkeʃiːdæn/
هویج	/hæviːd͡ʒ/
یهودی	/jæhuːdiː/
یهودیت	/jæhuːdiːjæt/
یهودی‌ستیزی	/jæhuːdiːsetiːziː/
یهودستیزی	/jæhuːdsetiːziː/
هورمون	/huːɾmuːn/
هوس	/hævæs/
هوس کردن	/hævæskæɾdæn/
هوش	/huːʃ/
هوشمند	/huːʃmænd/
هوشمند	/huːŝmænd/
هول	/hoʊl/
هولی	/holiː/
هول زدن	/hoʊlzædæn/
هوموفوبیا	/huːmuːfuːbiːjɒː/
یهوه	/jæhve/
هوو	/hævuː/
و	/o/
و	/o/, /væ/
و	/væ/
وات	/vɒːt/
واتیکان	/vɒːtiːkɒːn/
واج	/vɒːd͡ʒ/
واحد نجومی	/vɒːhed nod͡ʒuːmiː/
واحه	/vɒːhe/
وادی	/vɒːdiː/
وارسی	/vɒːɾesiː/
وارسی کردن	/vɒːɾesiːkæɾdæn/
واروژان	/vɒːɾuːʒɒːn/
واژگان	/vɒːʒeɡɒːn/
واژن	/vɒːʒæn/
واژه	/vɒːʒe/
واژهشناسی	/vɒːʒeʃenæsiː/
واژه‌نامه	/vɒːʒenɒːme/
یواش	/jævɒːʃ/
واشنگتن	/vɒːʃenɡton/
.واشینگتن دی.سی	/vɒːʃenɡton diː.siː./
وایفای	/vɒːjfɒːj/
وافن اس‌اس	/vɒːfen es es/
واقعی	/vɒːɢeiː/
واکس	/vɒːks/
واکس زدن	/vɒːkszædæn/
واکسن	/vɒːksæn/
واکسن زدن	/vɒːksænzædæn/
واکسن کردن	/vɒːksænkæɾdæn/
واکنشگاه هسته‌ای	/vɒːkoneʃɡɒːhe hæsteʔiː/
واگن	/vɒːɡon/
وال	/vɒːl/
والیبال	/vɒːliːbɒːl/
والدین	/vɒːledejn/
والده	/vɒːlede/
وام‌واژه	/vɒːmvɒːʒe/
یوان	/juːɒːn/
وان	/vɒːn/
واو	/vɒːv/
وب‌گاه	/vebɡɒːh/
وبلاگ	/veblɒːɡ/
وبلاگ زدن	/veblɒːɡzædæn/
وب نوشت	/veb neveʃt/
ویتنام	/viːjætnɒːm/
ویتنامی	/viːjætnɒːmiː/
یوتیوب	/juːtjuːb/
وجد	/væd͡ʒd/
وجد آمدن	/væd͡ʒdɒːmædæn/
وجد آوردن	/væd͡ʒdɒːvæɾdæn/
وجود	/vod͡ʒuːd/
وجود آمدن	/vod͡ʒuːdɒːmædæn/
وجود آوردن	/vod͡ʒuːdɒːvæɾdæn/
وجود داشتن	/vod͡ʒuːddɒːʃtæn/
وحشی	/væhʃiː/
وحشت	/væhʃæt/
وحشت کردن	/væhʃætkæɾdæn/
وداع	/vedɒːʔ/
وداع کردن	/vedɒːʔkæɾdæn/
ودکا	/vodkɒː/
ور	/veɾ/
ویرایش	/viːɾɒːjeʃ/
ویرایش کردن	/viːɾɒːjeʃ kæɾdæn/
ویرایشگر	/viːɾɒːjeʃɡæɾ/
یورتمه	/joɾtmæ/
ورزا	/væɾzɒː/
ور زدن	/veɾzædæn/
ورزش	/væɾzeʃ/
ورزشگاه	/væɾzeʃɡɒːh/
یورش	/joɾeʃ/
یورش	/juːɾeʃ/
یورش آوردن	/joɾeʃɒːvæɾdæn/
یورش بردن	/joɾeʃboɾdæn/
ورشو	/væɾʃouː/
ورق 	/væɾæɢ/
ورق  خوردن	/væɾæɢxoɾdæn/
ورق  زدن	/væɾæɢzædæn/
ورقه	/væɾæɢe/
ویرگول	/viːɾɡuːl/
ورم	/væɾæm/
ورم کردن	/væɾæmkæɾdæn/
یورو	/juːɾo/
ورود	/voɾuːd/
ورودی	/voɾuːdiː/
یوز	/juːz/
ویزا	/viːzɒː/
یوزپلنگ	/juːzpælænɡ/
وزیر	/væziːɾ/
وزن	/væzn/
وزن کردن	/væznkæɾdæn/
وزنه	/væzne/
وزنه زدن	/væznezædæn/
ویژه	/viːʒæ/
وسترن	/vesteɾn/
وسعت	/vosʔæt/
وسعت دادن	/vosʔætdɒːdæn/
ویسکی	/viːskiː/
ویشنو	/viːʃnuː/
وصفی	/væsfiː/
وصل	/væsl/
وصلت	/væslæt/
وصلت کردن	/væslætkæɾdæn/
وصل کردن	/væslkæɾdæn/
وصله	/væsle/
وصله زدن	/væslezædæn/
وصله کردن	/væslekæɾdæn/
وصول	/vosuːl/
وصول کردن	/vosuːlkæɾdæn/
وضعیت	/vædiːjet/
وضو	/vozuː/
وطن	/vætæn/
وعده	/væʔde/
وعده دادن	/væʔdedɒːdæn/
وق	/væɢ/
وقت	/væɢt/
وقتی	/væɢtiː/
وقتی که	/væɢtiː ke/
وقت گل نی	/væɢt e ɡol e nej/
وق زدن	/væɢzædæn/
ویکی	/viːkiː/
ویکی‌پدیا	/viːkiːpediːjɒː/
ویکتوریا	/viːktuːɾiːjɒː/
وکیل	/vækiːl/
ویکی‌واژه	/viːkiːvɒːʒe/
ولی	/vɒːliː/
ویلا	/viːllɒː/, /viːlɒː/
ولاپوک	/volɒːpuːk/
ولادی‌وستوک	/velɒːdiːvostuːk/
ولت	/volt/
ویلز	/vejlz/
ولزی	/velziː/
ولزی‌ها	/velziːhɒː/
ولفرام	/volfɾɒːm/
ولگا	/volɡɒː/
ولوو	/volvo/
ون	/væn/
وین	/viːn/
یونان	/juːnɒːn/
یونانی	/juːnɒːniː/
وینتیان	/ventiːɒːn/
ونزوئلا	/venezuːelɒː/
ونسان ونگوگ	/vænsɒːn vænɡôɡ/
یونی‌کد	/juːniːkod/
یونیکس	/juːniːks/
ونکوور	/vænkuːveɾ/
ونگ	/vænɡ/
ونگ زدن	/vænɡzædæn/
ونگوگ	/vænɡôɡ/
وهم	/væhm/
ووتیک	/votiːk/
وول	/vuːl/
وول خوردن	/vuːlxoɾdæn/
وول زدن	/vuːlzædæn/
ویولن	/viːjolon/
وولوگدا	/vuːluːɡdɒː/
يشب	/jæʃb/
يشم	/jæʃm/
يوزپلنگ	/juːzpælænɡ/
